############################################
### ACCOMPLIST GENERATED WHITELIST       ###
### Version: 1732684103                  ###
### Chris Buijs                          ###
### https://github.com/cbuijs/accomplist ###
############################################

### SAFELIST DOMAINS ###
### SAFEUNWHITELIST DOMAINS ###
### WHITELIST REGEXES ###
### WHITELIST DOMAINS ###
rakbankonline.ae	Adguard-Banks-White
donut.ai	Chris-Whitelist
troops.ai	Chris-Whitelist
internetbank.armbusinessbank.am	Adguard-Banks-White
money.idram.am	Adguard-Banks-White
online.inecobank.am	Adguard-Banks-White
online.procreditbank.am	Adguard-Banks-White
ibanking.vtb.am	Adguard-Banks-White
bunq.app	Adguard-Banks-White
picnic.app	Chris-Whitelist
accessbanking.com.ar	Adguard-Banks-White
bancon.bancor.com.ar	Adguard-Banks-White
bbva.com.ar	Adguard-Banks-White
online-banking.hsbc.com.ar	Adguard-Banks-White
icbc.com.ar	Adguard-Banks-White
nu.com.ar	Adguard-Banks-White
online.bankaustria.at	Adguard-Banks-White
cert.at	Chris-Whitelist
banking.co.at	Adguard-Banks-White
ebanking.easybank.at	Adguard-Banks-White
banking.ing-diba.at	Adguard-Banks-White
llb.at	Adguard-Banks-White
banking.raiffeisen.at	Adguard-Banks-White
renault-bank-direkt.at	Adguard-Banks-White
service.santanderconsumer.at	Adguard-Banks-White
sparkasse.at	Adguard-Banks-White
vakifbank.at	Adguard-Banks-White
adelaidebank.com.au	Adguard-Banks-White
amp.com.au	Adguard-Banks-White
anz.com.au	Adguard-Banks-White
digital.bankaust.com.au	Adguard-Banks-White
bankfirst.com.au	Adguard-Banks-White
ibanking.bankofmelbourne.com.au	Adguard-Banks-White
banksa.com.au	Adguard-Banks-White
bankwest.com.au	Adguard-Banks-White
bendigobank.com.au	Adguard-Banks-White
online.beyondbank.com.au	Adguard-Banks-White
boq.com.au	Adguard-Banks-White
coinspot.com.au	Adguard-Banks-White
commbank.com.au	Adguard-Banks-White
commsec.com.au	Adguard-Banks-White
financialservicesonline.com.au	UT1-Finance
financialstandard.com.au	UT1-Finance
freelancer.com.au	Adguard-Sensitive-White
online.gemvisa.com.au	Adguard-Banks-White
hotdoc.com.au	Adguard-Sensitive-White
hsbc.com.au	Adguard-Banks-White
ing.com.au	Adguard-Banks-White
ingdirect.com.au	Adguard-Banks-White
latitudefinancial.com.au	UT1-Finance
macquarie.com.au	Adguard-Banks-White
migs.mastercard.com.au	Adguard-Banks-White
mebank.com.au	Adguard-Banks-White
nab.com.au	Adguard-Banks-White
rams.com.au	Adguard-Banks-White
selfwealth.com.au	Adguard-Banks-White
stgeorge.com.au	Adguard-Banks-White
suncorp.com.au	Adguard-Banks-White
internetbanking.suncorpbank.com.au	Adguard-Banks-White
unicornfinancial.com.au	UT1-Finance
vicsuper.com.au	Adguard-Banks-White
banking.westpac.com.au	Adguard-Banks-White
gov.au	Adguard-Sensitive-White
cryptoaustralia.org.au	Chris-Whitelist
financialcounsellingaustralia.org.au	UT1-Finance
financialrights.org.au	UT1-Finance
accessbank.az	Adguard-Banks-White
afb.az	Adguard-Banks-White
agbank.az	Adguard-Banks-White
amrahbank.az	Adguard-Banks-White
asb.az	Adguard-Banks-White
azerturkbank.az	Adguard-Banks-White
bankavrasiya.az	Adguard-Banks-White
bankrespublika.az	Adguard-Banks-White
banksilkway.az	Adguard-Banks-White
btb.az	Adguard-Banks-White
cbar.az	Adguard-Banks-White
yapikredi.com.az	Adguard-Banks-White
online.expressbank.az	Adguard-Banks-White
goldenpay.az	Adguard-Banks-White
login.e-taxes.gov.az	Adguard-Banks-White
hesab.az	Adguard-Banks-White
ibar.az	Adguard-Banks-White
kapitalbank.az	Adguard-Banks-White
pay.millikart.az	Adguard-Banks-White
muganbank.az	Adguard-Banks-White
naxcivanbank.az	Adguard-Banks-White
nbcbank.az	Adguard-Banks-White
nikoil.az	Adguard-Banks-White
pashabank.az	Adguard-Banks-White
portmanat.az	Adguard-Banks-White
turanbank.az	Adguard-Banks-White
unibank.az	Adguard-Banks-White
vtb.az	Adguard-Banks-White
xalqbank.az	Adguard-Banks-White
ziraatbank.az	Adguard-Banks-White
sparkasse.ba	Adguard-Banks-White
ziraatbank.ba	Adguard-Banks-White
my.helaba.bank	Adguard-Banks-White
vostok.bank	Adguard-Banks-White
www.bdbl.com.bd	Adguard-Banks-White
bgcb.com.bd	Adguard-Banks-White
citytouch.com.bd	Adguard-Banks-White
ebl.com.bd	Adguard-Banks-White
www.first-finance.com.bd	Adguard-Banks-White
freelancer.com.bd	Adguard-Sensitive-White
www.hsbc.com.bd	Adguard-Banks-White
www.ificbank.com.bd	Adguard-Banks-White
www.meghnabank.com.bd	Adguard-Banks-White
www.mfl.com.bd	Adguard-Banks-White
nagad.com.bd	Adguard-Banks-White
www.nccbank.com.bd	Adguard-Banks-White
www.nfl.com.bd	Adguard-Banks-White
phoenixfinance.com.bd	Adguard-Banks-White
www.premierleasing.com.bd	Adguard-Banks-White
www.primebank.com.bd	Adguard-Banks-White
rupalibank.com.bd	Adguard-Banks-White
www.sabinco.com.bd	Adguard-Banks-White
www.sonalibank.com.bd	Adguard-Banks-White
www.southeastbank.com.bd	Adguard-Banks-White
thefinancialexpress.com.bd	UT1-Finance
www.trustbank.com.bd	Adguard-Banks-White
www.ucb.com.bd	Adguard-Banks-White
www.ulc.com.bd	Adguard-Banks-White
www.unionbank.com.bd	Adguard-Banks-White
www.pkb.gov.bd	Adguard-Banks-White
www.asa.org.bd	Adguard-Banks-White
www.biffl.org.bd	Adguard-Banks-White
www.krishibank.org.bd	Adguard-Banks-White
www.rakub.org.bd	Adguard-Banks-White
vluggeld.140provision.be	UT1-Finance
argenta.be	Adguard-Banks-White
belfius.be	Adguard-Banks-White
online.beobank.be	Adguard-Banks-White
bnpparibasfortis.be	Adguard-Banks-White
bpostbank.be	Adguard-Banks-White
bpostbanque.be	Adguard-Banks-White
buyway.be	Adguard-Banks-White
carrefourfinance.be	Adguard-Banks-White
ing.be	Adguard-Banks-White
kbc.be	Adguard-Banks-White
keytradebank.be	Adguard-Banks-White
youtu.be	AnuDeep
wallet.best	Adguard-Banks-White
online.bulbank.bg	Adguard-Banks-White
bulbankonline.bg	Adguard-Banks-White
online.ccbank.bg	Adguard-Banks-White
epay.bg	Adguard-Banks-White
login-portal.nra.bg	Adguard-Banks-White
sgeb.bg	Adguard-Banks-White
ziraatbank.bg	Adguard-Banks-White
calypsofinancial.biz	UT1-Finance
dscloud.biz	Adguard-Sensitive-White
robinsonfinancial.biz	UT1-Finance
ucpb.biz	Adguard-Banks-White
www.uttarafinance.biz	Adguard-Banks-White
winfric.biz	UT1-Finance
mabanque.bnpparibas	Adguard-Banks-White
mabanqueprivee.bnpparibas	Adguard-Banks-White
easy.box	Adguard-Issues-White
fritz.box	Chris-Whitelist, Adguard-Issues-White
banpara.b.br	Adguard-Banks-White
agibank.com.br	Adguard-Banks-White
agorainvestimentos.com.br	Adguard-Banks-White
bancoalfa.com.br	Adguard-Banks-White
bancoamazonia.com.br	Adguard-Banks-White
bancobrasil.com.br	Adguard-Banks-White
bancobs2.com.br	Adguard-Banks-White
bancodigimais.com.br	Adguard-Banks-White
bancodobrasil.com.br	Adguard-Banks-White
bancofibra.com.br	Adguard-Banks-White
bancointer.com.br	Adguard-Banks-White
bancopan.com.br	Adguard-Banks-White
banese.com.br	Adguard-Banks-White
banestes.com.br	Adguard-Banks-White
banrisul.com.br	Adguard-Banks-White
bb.com.br	Adguard-Banks-White
bbancobmg.com.br	Adguard-Banks-White
bib.com.br	Adguard-Banks-White
bradesco.com.br	Adguard-Banks-White
novo.brb.com.br	Adguard-Banks-White
brde.com.br	Adguard-Banks-White
btgpactualdigital.com.br	Adguard-Banks-White
bv.com.br	Adguard-Banks-White
c6bank.com.br	Adguard-Banks-White
cielo.com.br	Adguard-Banks-White
clear.com.br	Adguard-Banks-White
credicard.com.br	Adguard-Banks-White
digio.com.br	Adguard-Banks-White
foxbit.com.br	Adguard-Banks-White
itau.com.br	Adguard-Banks-White
mercadobitcoin.com.br	Adguard-Banks-White
mercadopago.com.br	Adguard-Banks-White
mercantildobrasil.com.br	Adguard-Banks-White
modalmais.com.br	Adguard-Banks-White
neon.com.br	Adguard-Banks-White
nubank.com.br	Adguard-Banks-White
nuinvest.com.br	Adguard-Banks-White
orama.com.br	Adguard-Banks-White
original.com.br	Adguard-Banks-White
paranabanco.com.br	Adguard-Banks-White
portoseguro.com.br	Adguard-Banks-White
quantaprevidencia.com.br	Adguard-Banks-White
recargapay.com.br	Adguard-Banks-White
safra.com.br	Adguard-Banks-White
santander.com.br	Adguard-Banks-White
sicoob.com.br	Adguard-Banks-White
sicredi.com.br	Adguard-Banks-White
sofisadireto.com.br	Adguard-Banks-White
stone.com.br	Adguard-Banks-White
ton.com.br	Adguard-Banks-White
toroinvestimentos.com.br	Adguard-Banks-White
unicred.com.br	Adguard-Banks-White
pagseguro.uol.com.br	Adguard-Banks-White
userede.com.br	Adguard-Banks-White
xpi.com.br	Adguard-Banks-White
bnb.gov.br	Adguard-Banks-White
bndes.gov.br	Adguard-Banks-White
caixa.gov.br	Adguard-Banks-White, UT1-Finance
dec.fazenda.df.gov.br	Adguard-Sensitive-White
receita.economia.gov.br	Adguard-Sensitive-White
cnisnet.inss.gov.br	Adguard-Sensitive-White
meu.inss.gov.br	Adguard-Sensitive-White
bdmg.mg.gov.br	Adguard-Banks-White
banco.bradesco	Adguard-Banks-White
alfa-bank.by	Adguard-Banks-White
ibank.asb.by	Adguard-Banks-White
ibank.belapb.by	Adguard-Banks-White
ibank.belinvestbank.by	Adguard-Banks-White
i-bank.bgpb.by	Adguard-Banks-White
bps-sberbank.by	Adguard-Banks-White
bsb.by	Adguard-Banks-White
online.btabank.by	Adguard-Banks-White
e-bgpb.by	Adguard-Banks-White
e-pay.by	Adguard-Banks-White
ssl.easypay.by	Adguard-Banks-White
ibank.fransabank.by	Adguard-Banks-White
hc24.by	Adguard-Banks-White
i-vtb.by	Adguard-Banks-White
pay.i24.by	Adguard-Banks-White
ib.ideabank.by	Adguard-Banks-White
ideabank24.by	Adguard-Banks-White
imbanking.by	Adguard-Banks-White
ihelper.mts.by	Adguard-Issues-White
new.mybank.by	Adguard-Banks-White
client.paritetbank.by	Adguard-Banks-White
ibank.paritetbank.by	Adguard-Banks-White
prior.by	Adguard-Banks-White
priorbank.by	Adguard-Banks-White
sber-bank.by	Adguard-Banks-White
sbsibank.by	Adguard-Banks-White
it.tb.by	Adguard-Banks-White
tbank.trustbank.by	Adguard-Banks-White
id.yandex.by	Adguard-Sensitive-White
passport.yandex.by	Adguard-Sensitive-White
ibank.zepterbank.by	Adguard-Banks-White
cpms.spop10.ams.plex.bz	AnuDeep
cpms35.spop10.ams.plex.bz	AnuDeep
meta.plex.bz	AnuDeep
proxy02.pop.ord.plex.bz	AnuDeep
proxy.plex.bz	AnuDeep
pubsub.plex.bz	AnuDeep
meta-db-worker02.pop.ric.plex.bz	AnuDeep
1password.ca	Adguard-Sensitive-White
secured.acu.ca	Adguard-Banks-White
affinitycu.ca	Adguard-Banks-White
alterna.ca	Adguard-Banks-White
banquelaurentienne.ca	Adguard-Banks-White
bnc.ca	Adguard-Banks-White
canadapost.ca	Adguard-Sensitive-White
chasecanada.ca	Adguard-Banks-White
signin.ebay.ca	Adguard-Banks-White
envisionfinancial.ca	UT1-Finance
eqbank.ca	Adguard-Banks-White
fbngp.ca	Adguard-Banks-White
firstwestcu.ca	Adguard-Banks-White
freelancer.ca	Adguard-Sensitive-White
cra-arc.gc.ca	Adguard-Sensitive-White
hsbc.ca	Adguard-Banks-White
scu.mb.ca	Adguard-Banks-White
meridiancu.ca	Adguard-Banks-White
pcfinancial.ca	UT1-Finance
prospera.ca	Adguard-Banks-White
emploiquebec.gouv.qc.ca	Adguard-Mac-White
refreshfinancial.ca	UT1-Finance
servus.ca	Adguard-Banks-White
simpletax.ca	Adguard-Banks-White
springfinancial.ca	UT1-Finance
tangerine.ca	Adguard-Banks-White
tsfinancial.ca	UT1-Finance
westernfinancialgroup.ca	UT1-Finance
scalable.capital	Adguard-Banks-White
prospera.oauth.live.central1.cc	Adguard-Banks-White
axiomfinancials.cf	UT1-Finance
bstreetfinancial.cf	UT1-Finance
abuse.ch	Chris-Whitelist
akb.ch	Adguard-Banks-White
banklinth.ch	Adguard-Banks-White
bcj.ch	Adguard-Banks-White
bcv.ch	Adguard-Banks-White
bekb.ch	Adguard-Banks-White
bhf-bank.ch	Adguard-Banks-White
bkb.ch	Adguard-Banks-White
blkb.ch	Adguard-Banks-White
companyonline.ch	Adguard-Banks-White
icorner.ch	Adguard-Banks-White
ice.infomaniak.ch	Chris-Whitelist
masterpass.ch	Adguard-Banks-White
migrosbank.ch	Adguard-Banks-White
onba.ch	Adguard-Banks-White
postfinance.ch	Adguard-Banks-White
protonmail.ch	Adguard-Sensitive-White
raiffeisen.ch	Adguard-Banks-White
sgkb.ch	Adguard-Banks-White
swisscard.ch	Adguard-Banks-White
swisslife.ch	Adguard-Issues-White
twint.ch	Adguard-Banks-White
valiant.ch	Adguard-Banks-White
viseca.ch	Adguard-Banks-White
visecaone.ch	Adguard-Banks-White
zkb.ch	Adguard-Banks-White
simplex.chat	Include
tamtam.chat	Adguard-Android-White
bancochile.cl	Adguard-Banks-White
bancoconsorcio.cl	Adguard-Banks-White
bancoestado.cl	Adguard-Banks-White
bancofalabella.cl	Adguard-Banks-White
bancointernacional.cl	Adguard-Banks-White
bancoripley.cl	Adguard-Banks-White
bancosecurity.cl	Adguard-Banks-White
bice.cl	Adguard-Banks-White
cmr.cl	Adguard-Banks-White
freelancer.cl	Adguard-Sensitive-White
itau.cl	Adguard-Banks-White
santander.cl	Adguard-Banks-White
scotiabank.cl	Adguard-Banks-White
scotiabankchile.cl	Adguard-Banks-White
tarjetacencosud.cl	Adguard-Banks-White
transbank.cl	Adguard-Banks-White
boc.cn	Adguard-Banks-White
financialnews.com.cn	UT1-Finance
icbc.com.cn	Adguard-Banks-White
icloud.com.cn	Adguard-Mac-White
freelancer.cn	Adguard-Sensitive-White
g.cn	Chris-Connect
aafmaafinancial.co	UT1-Finance
avvillas.com.co	Adguard-Banks-White
bancamia.com.co	Adguard-Banks-White
bancodeoccidente.com.co	Adguard-Banks-White
bancofalabella.com.co	Adguard-Banks-White
bancoomeva.com.co	Adguard-Banks-White
bancopichincha.com.co	Adguard-Banks-White
bancopopular.com.co	Adguard-Banks-White
bancoprocredit.com.co	Adguard-Banks-White
bancow.com.co	Adguard-Banks-White
bbva.com.co	Adguard-Banks-White
citibank.com.co	Adguard-Banks-White
colpatria.com.co	Adguard-Banks-White
coopcentral.com.co	Adguard-Banks-White
gnbsudameris.com.co	Adguard-Banks-White
nu.com.co	Adguard-Banks-White
santander.com.co	Adguard-Banks-White
bancoagrario.gov.co	Adguard-Banks-White
blocklist.greensnow.co	Chris-Whitelist
guarda.co	Adguard-Banks-White
itau.co	Adguard-Banks-White
t.co	AnuDeep
wwrk.co	Chris-Whitelist
1drv.com	AnuDeep
1password.com	Adguard-Sensitive-White
2checkout.com	Adguard-Banks-White
netlab.360.com	Chris-Whitelist
365financialanalyst.com	UT1-Finance
4sq.com	Chris-Whitelist
53.com	Adguard-Banks-White
cdn-icloud-content.g.aaplimg.com	Chris-Whitelist
portal.aareal.com	Adguard-Banks-White
kautionen.aareal-bank.com	Adguard-Banks-White
app.aave.com	Adguard-Banks-White
aazsysteme.com	UT1-Finance
abacus.com	Chris-Whitelist
abanca.com	Adguard-Banks-White
www.abbl.com	Adguard-Banks-White
abc.com	Chris-Whitelist
abcbourse.com	UT1-Finance
abcfinancial.com	UT1-Finance
abchina.com	Adguard-Banks-White
abcnews.com	Chris-Whitelist
abfinancial.com	UT1-Finance
ib.ablv.com	Adguard-Banks-White
terminal.accentpay.com	Adguard-Banks-White
accessbankplc.com	Adguard-Banks-White
accounting-financial-tax.com	UT1-Finance
accrobourse.com	UT1-Finance
api.accuweather.com	Adguard-Android-White
acledabank-internetbanking.com	Adguard-Banks-White
acorns.com	Adguard-Banks-White, UT1-Finance
secure.acquiropay.com	Adguard-Banks-White
acs-education.com	Adguard-Banks-White
online.adcb.com	Adguard-Banks-White
adguard.com	Chris-Whitelist
app.adjust.com	Pi-DNS
admuncher.com	Chris-Whitelist
get3.adobe.com	Chris-Whitelist
assets.adobedtm.com	Pi-DNS
npr-news.streaming.adswizz.com	AnuDeep
mein.advanzia.com	Adguard-Banks-White
wallet.advcash.com	Adguard-Banks-White
fr.advfn.com	UT1-Finance
adyen.com	Adguard-Banks-White
africanfinancials.com	UT1-Finance
agorafinancial.com	UT1-Finance
in.agri-bank.com	Adguard-Banks-White
online.agroprombank.com	Adguard-Banks-White
banking.airbusbank.com	Adguard-Banks-White
akamaitechnologies.com	AnuDeep
akbank.com	Adguard-Banks-White
www.al-arafahbank.com	Adguard-Banks-White
alahli.com	Adguard-Banks-White
alawwalbank.com	Adguard-Banks-White
albelli.com	Chris-Whitelist
ae01.alicdn.com	Chris-Whitelist
reputation.alienvault.com	Chris-Whitelist
alinma.com	Adguard-Banks-White
alipay.com	Adguard-Banks-White
alleviatefinancial.com	UT1-Finance
allfinancialmatters.com	UT1-Finance
alliantcreditunion.com	Adguard-Banks-White
allworthfinancial.com	UT1-Finance
ally.com	Adguard-Banks-White
almasfinancialservices.com	UT1-Finance
altbank.com	Adguard-Banks-White
althea-groupe.com	UT1-Finance
altoneo.com	UT1-Finance
amazon.com	Chris-Whitelist
s.amazon-adsystem.com	Pi-DNS
amazonaws.com	AnuDeep
sonos.amazonmusic.com	Chris-Whitelist
sonos.sonos-lbr.amazonmusic.com	Chris-Whitelist
amedigital.com	Adguard-Banks-White
amerantbank.com	Adguard-Banks-White
americanexpress.com	Chris-Whitelist, Adguard-Banks-White, UT1-Finance
ampproject.com	Chris-Whitelist
amtrak.com	Chris-Whitelist
amtrustfinancial.com	UT1-Finance
amundi-tc.com	Adguard-Banks-White
ancestry.com	Chris-Whitelist
anchorfinancialsvc.com	UT1-Finance
android.com	Chris-Whitelist
anonaddy.com	Adguard-Sensitive-White
ebank.ansarbank.com	Adguard-Banks-White
ansfinancial.com	UT1-Finance
answerfinancial.com	UT1-Finance
anveo.com	Chris-Whitelist
anz.com	Adguard-Banks-White
apc.com	Chris-Whitelist
apcc.com	Chris-Whitelist
apple.com	Adguard-Mac-White
api.apple-cloudkit.com	Adguard-Issues-White
appleiphonecell.com	Chris-Whitelist, Chris-Connect
apsiyon.com	Adguard-Banks-White
secure5.arcot.com	Adguard-Banks-White
asiafinancial.com	UT1-Finance
asiatimesfinancial.com	UT1-Finance
ask-assets.com	UT1-Finance
askfinancials.com	UT1-Finance
aspnetcdn.com	AnuDeep
astfinancial.com	UT1-Finance
at-bourse.com	UT1-Finance
atabank.com	Adguard-Banks-White
clientproxyservice.atomtickets.com	Adguard-Android-White
ws.audioscrobbler.com	AnuDeep
auxmoney.com	Adguard-Banks-White
avangate.com	Adguard-Banks-White
avira.com	Chris-Whitelist
www.avivabd.com	Adguard-Banks-White
axa.com	UT1-Finance
axisbank.com	Adguard-Banks-White
support.iam.ad.azure.com	MMoti
main.iam.ad.ext.azure.com	MMoti
b-capital.com	UT1-Finance
ba.com	Chris-Whitelist
babasbrew.com	Chris-Whitelist
bac-assets.com	Chris-Whitelist
badips.com	Chris-Whitelist
bairdfinancialadvisor.com	UT1-Finance
online.baltinvest.com	Adguard-Banks-White
osint.bambenekconsulting.com	Chris-Whitelist
checkout.bambora.com	Adguard-Sensitive-White
web.bancadigitalbod.com	Adguard-Banks-White
online.bancamiga.com	Adguard-Banks-White
bancnetonline.com	Adguard-Banks-White
bancoactivo.com	Adguard-Banks-White
bancocajasocial.com	Adguard-Banks-White
bancodebogota.com	Adguard-Banks-White
bancoexterior.com	Adguard-Banks-White
bancofinandina.com	Adguard-Banks-White
bancoldex.com	Adguard-Banks-White
bancomer.com	Adguard-Banks-White
bancaenlinea.bancoplaza.com	Adguard-Banks-White
bancrecerdigital.com	Adguard-Banks-White
bancsabadell.com	Adguard-Banks-White
banesconline.com	Adguard-Banks-White
bangkokbank.com	Adguard-Banks-White
corpclb.bank-premium.com	Adguard-Banks-White
bankalbilad.com	Adguard-Banks-White
www.bankalfalah.com	Adguard-Banks-White
www.bankasia-bd.com	Adguard-Banks-White
bankchb.com	Adguard-Banks-White
bankcomm.com	Adguard-Banks-White
online.bankfab.com	Adguard-Banks-White
bankfinancial.com	UT1-Finance
bankinter.com	Adguard-Banks-White
online.bankirdom.com	Adguard-Banks-White
bk.banklviv.com	Adguard-Banks-White
ibank.bankmega.com	Adguard-Banks-White
saba.bankmelli-iran.com	Adguard-Banks-White
bankofamerica.com	Chris-Whitelist, Adguard-Banks-White
bankofbaku.com	Adguard-Banks-White
bankofbeirut.com	Adguard-Banks-White
ap.ebs.bankofchina.com	Adguard-Banks-White
online.bankofcyprus.com	Adguard-Banks-White
banktonfinancial.com	UT1-Finance
banorte.com	Adguard-Banks-White
banplusonline.com	Adguard-Banks-White
bdvenlinea.banvenez.com	Adguard-Banks-White
e-bdv.banvenez.com	Adguard-Banks-White
barclaycardus.com	Adguard-Banks-White
www.basicbanklimited.com	Adguard-Banks-White
bauerfinancial.com	UT1-Finance
ebanking.bawagpsk.com	Adguard-Banks-White
display.ugc.bazaarvoice.com	AnuDeep
bbacbank.com	Adguard-Banks-White
bbc.com	Chris-Whitelist
bcblbd.com	Adguard-Banks-White
bccard.com	Adguard-Android-White
ibank.bcs-bank.com	Adguard-Banks-White
betterment.com	Adguard-Banks-White
bhf-bank.com	Adguard-Banks-White
bibbyfinancialservices.com	UT1-Finance
bancaenlinea.bicentenariobu.com	Adguard-Banks-White
bidv.com	Adguard-Banks-White
www.bifcol.com	Adguard-Banks-White
bigboss-financial.com	UT1-Finance
bil.com	Adguard-Banks-White
billdesk.com	Adguard-Banks-White
id.biltema.com	Adguard-Sensitive-White
binance.com	Adguard-Sensitive-White
binarydefense.com	Chris-Whitelist
websockets.platform.bing.com	Adguard-Android-White
homebrew.bintray.com	Chris-Whitelist
wallet.bitcoin.com	Adguard-Banks-White
bitfinex.com	Adguard-Banks-White
bitget.com	Adguard-Banks-White
bitpanda.com	Adguard-Banks-White
bitso.com	Adguard-Banks-White
bittrex.com	Adguard-Banks-White
bitwala.com	Adguard-Banks-White
bitwarden.com	Adguard-Sensitive-White
bity.com	Adguard-Banks-White
www.bkash.com	Adguard-Banks-White
goods.bbm.blackberry.com	Adguard-Android-White
profile.bbm.blackberry.com	Adguard-Android-White
global.uci.blackberry.com	Adguard-Android-White
my.blackhawkbank.com	Adguard-Banks-White
www.blilbd.com	Adguard-Banks-White
login.blockchain.com	Adguard-Banks-White
blockchainfinancialtimes.com	UT1-Finance
blockfi.com	Adguard-Banks-White
blombank.com	Adguard-Banks-White
bloomberg.com	Chris-Whitelist
blueshorefinancial.com	UT1-Finance
cp.bluesnap.com	Adguard-Banks-White
bmo.com	Adguard-Banks-White
bmoharris.com	Adguard-Banks-White
bnpparibas.com	Adguard-Banks-White
bobfinancial.com	UT1-Finance
bobibanking.com	Adguard-Banks-White
bochk.com	Adguard-Banks-White
bofaml.com	Chris-Whitelist
bokfinancial.com	UT1-Finance
secure.booking.com	Adguard-Banks-White
boursediscount.com	UT1-Finance
boursica.com	UT1-Finance
boursier.com	UT1-Finance
boursorama.com	Adguard-Banks-White, UT1-Finance
boursorama2.com	UT1-Finance
api.box.com	Adguard-Android-White
boxcryptor.com	Adguard-Issues-White
bpcprocessing.com	Adguard-Banks-White
bpiexpressonline.com	Adguard-Banks-White
www.bracbank.com	Adguard-Banks-White
payments.braintree-api.com	Adguard-Banks-White
breadfinancial.com	UT1-Finance
breakingnewsfinancial.com	UT1-Finance
brightcove.com	Adguard-Android-White
brighthousefinancial.com	UT1-Finance
britishairways.com	Chris-Whitelist
wallet.btc.com	Adguard-Banks-White
btc-e.com	Adguard-Banks-White
btgpactual.com	Adguard-Banks-White
btpn.com	Adguard-Banks-White
budgetbankers.com	Adguard-Android-White
bunq.com	Adguard-Banks-White
buttonwoodsbrewery.com	Chris-Whitelist
bybit.com	Adguard-Banks-White
c2financialcorp.com	UT1-Finance
caixa-enginyers.com	Adguard-Banks-White
caminofinancial.com	UT1-Finance
campuscu.com	Adguard-Banks-White
cannonfinancial.com	UT1-Finance
capeasi.com	UT1-Finance
capitalfinancialgroupinc.com	UT1-Finance
capitalfundingfinancial.com	UT1-Finance
capitalone.com	Adguard-Banks-White
carbonaccountingfinancials.com	UT1-Finance
cardinalfinancial.com	UT1-Finance
cardpay.com	Adguard-Banks-White
careerbuilder.com	Chris-Whitelist
onlinebanking.cargillsbank.com	Adguard-Banks-White
cashadvanceclub.com	UT1-Finance
cashtracksfinancial.com	UT1-Finance
casino-astucess.com	UT1-Finance
casinoo-astuces.com	UT1-Finance
caymanfinancialreview.com	UT1-Finance
om.cbsi.com	AnuDeep
vidtech.cbsinteractive.com	AnuDeep
ccb.com	Adguard-Banks-White
ccbfinancial.com	UT1-Finance
ccservicing.com	Adguard-Banks-White
cdn-apple.com	Chris-Whitelist
cdn-secuchart.com	Adguard-Sensitive-White
cdninstagram.com	Chris-Whitelist
cdtaxfinancialservices.com	UT1-Finance
cfifinancial.com	UT1-Finance
cfinancialfreedom.com	UT1-Finance
changelly.com	Adguard-Banks-White
chase.com	Adguard-Banks-White
chathamfinancial.com	UT1-Finance
cheezburger.com	Chris-Whitelist
cbuprovidence.chickenkiller.com	Chris-Whitelist
chime.com	Adguard-Banks-White
chinatrust.com	Adguard-Banks-White
ping.chrisbuijs.com	Chris-Whitelist
payments.chronopay.com	Adguard-Banks-White
chzbgr.com	Chris-Whitelist
cibc.com	Adguard-Banks-White
ebanking.cibeg.com	Adguard-Banks-White
cifinancial.com	UT1-Finance
cinsscore.com	Chris-Whitelist
citi.com	Adguard-Banks-White
citibankonline.com	Adguard-Banks-White
europe.citidirect-eb.citicorp.com	Adguard-Banks-White
citidirectbeportalemea.citidirect.com	Adguard-Banks-White
portal.citidirect.com	Adguard-Banks-White
citizensbank.com	Adguard-Banks-White
www.citizensbankbd.com	Adguard-Banks-White
citizensbankonline.com	Adguard-Banks-White
citybankplc.com	Adguard-Banks-White
mbz19n.accounts.clickbank.com	Adguard-Banks-White
clickoptions.com	UT1-Finance
cline-financial.com	UT1-Finance
cliqz.com	Chris-Whitelist
cdnjs.cloudflare.com	AnuDeep
res.cloudinary.com	AnuDeep
cmbchina.com	Adguard-Banks-White, Adguard-Sensitive-White
cnb.com	Adguard-Banks-White
cnbc.com	Chris-Whitelist
cnet.com	Chris-Whitelist
cnhfinancial.com	UT1-Finance
coastal24.com	Adguard-Banks-White
coastcapitalsavings.com	Adguard-Banks-White
cobinhood.com	Adguard-Banks-White
coinbase.com	Adguard-Banks-White
colfinancial.com	UT1-Finance
colpatria.com	Adguard-Banks-White
columbusfinancialcoaching.com	UT1-Finance
combankdigital.com	Adguard-Banks-White
secure.commercegate.com	Adguard-Banks-White
cbportal.commerzbank.com	Adguard-Banks-White
commerzfinanz.com	Adguard-Banks-White
www.communitybankbd.com	Adguard-Banks-White
completeid.com	Adguard-Sensitive-White
computershare.com	Adguard-Banks-White
consumerfinancialserviceslawmonitor.com	UT1-Finance
cws.conviva.com	AnuDeep
livepassdl.conviva.com	AnuDeep
pings.conviva.com	AnuDeep
coopriderfinancial.com	UT1-Finance
copayco.com	Adguard-Banks-White
corebridgefinancial.com	UT1-Finance
cotofinancialplanning.com	UT1-Finance
countryfinancial.com	UT1-Finance
credit-suisse.com	Adguard-Banks-White
creditbank.com	Adguard-Banks-White
creditdnepr.com	Adguard-Banks-White
creditonebank.com	Adguard-Banks-White
secure.creditwestbank.com	Adguard-Banks-White
chbrr.crimea.com	Adguard-Banks-White
criptointercambio.com	Adguard-Banks-White
api.crunchyroll.com	Adguard-Android-White
ctbcbank.com	Adguard-Banks-White
currency.com	Adguard-Banks-White
www.cvcflbd.com	Adguard-Banks-White
secureacceptance.cybersource.com	Adguard-Banks-White
danamonline.com	Adguard-Banks-White
dashlane.com	Adguard-Sensitive-White
dataplicity.com	AnuDeep
davivienda.com	Adguard-Banks-White
db.com	Adguard-Banks-White
internet-banking.hk.dbs.com	Adguard-Banks-White
www.dbs.com	Adguard-Banks-White
app.deel.com	Adguard-Sensitive-White
definefinancial.com	UT1-Finance
www.deltabrac.com	Adguard-Banks-White
acikdeniz.denizbank.com	Adguard-Banks-White
acikdenizv2.denizbank.com	Adguard-Banks-White
basvuru.denizbank.com	Adguard-Banks-White
desertfinancial.com	UT1-Finance
desjardins.com	Adguard-Banks-White
devbnkphl.com	Adguard-Banks-White
dfcufinancial.com	UT1-Finance
dhakabankltd.com	Adguard-Banks-White
dhbbank.com	Adguard-Banks-White
dickssportinggoods.com	Chris-Whitelist
directfinance.com	UT1-Finance
directnet.com	Adguard-Banks-White
discover.com	Adguard-Banks-White
discoverfinancial.com	UT1-Finance
cbuhome.dnsalias.com	Chris-Whitelist
domofinance.com	UT1-Finance
drift.com	AnuDeep
driftt.com	AnuDeep
dropbox.com	Chris-Whitelist, Adguard-Android-White
dropboxapi.com	Chris-Whitelist, Adguard-Android-White
dropboxstatic.com	Chris-Whitelist
dropboxusercontent.com	Chris-Whitelist, Adguard-Android-White
dslreports.com	Chris-Whitelist
dsmynas.com	Adguard-Sensitive-White
online.dubaifirst.com	Adguard-Banks-White
dutchbanglabank.com	Adguard-Banks-White
dvbbank.com	Adguard-Banks-White
dyn.com	Chris-Whitelist
e-bankofbaku.com	Adguard-Banks-White
e-xacbank.com	Adguard-Issues-White
e2ro.com	Chris-Whitelist
earlygrowthfinancialservices.com	UT1-Finance
eastcoasttaxandfinancial.com	UT1-Finance
eastwestbanker.com	Adguard-Banks-White
easyfinancial.com	UT1-Finance
pg.eazy2pay.com	Adguard-Banks-White
ebase.com	Adguard-Banks-White
signin.ebay.com	Adguard-Banks-White
webebank.ebb-bg.com	Adguard-Banks-White
ib.ebl-bd.com	Adguard-Banks-White
ecommpay.com	Adguard-Banks-White
secure.ecopayz.com	Adguard-Banks-White
eddiebauer.com	Chris-Whitelist
edelmanfinancial.com	UT1-Finance
edelmanfinancialengines.com	UT1-Finance
edfinancial.com	UT1-Finance
edwardbaskett.com	UT1-Finance
eero.com	Chris-Whitelist
eeroassets.com	Chris-Whitelist
eeroup.com	Chris-Whitelist
eeroupdate.com	Chris-Whitelist
efinancial.com	UT1-Finance
efinancialcareers.com	UT1-Finance
efinancialgp.com	UT1-Finance
efinancialmodels.com	UT1-Finance
efinancialnews.com	UT1-Finance
egnyte.com	Chris-Whitelist
egyptian-witchcraft.com	UT1-Finance
elderlifefinancial.com	UT1-Finance
elevationsbanking.com	Adguard-Banks-White
elevationscu.com	Adguard-Banks-White
ellisbank.com	Adguard-Banks-White
embassyfinancialcorporation.com	UT1-Finance
cdn.embedly.com	AnuDeep
emiratesnbd.com	Adguard-Banks-White
internetsubesi.emirvarlik.com	Adguard-Banks-White
empirefinancialresearch.com	UT1-Finance
online.energbank.com	Adguard-Banks-White
engadget.com	Chris-Whitelist
enpara.com	Adguard-Banks-White
merchantsecurity.enstage.com	Adguard-Banks-White
equifax.com	Adguard-Sensitive-White
esecure-transaction.com	UT1-Finance
etrade.com	Adguard-Banks-White
eurobank-ua.com	Adguard-Banks-White
europeanfinancialreview.com	UT1-Finance
evenfinancial.com	UT1-Finance
evenroute.com	Chris-Whitelist
evite.com	Chris-Whitelist
evobanco.com	Adguard-Banks-White
nettbedriften.evry.com	Adguard-Banks-White
bank.eximb.com	Adguard-Banks-White
www.eximbankbd.com	Adguard-Banks-White
expatfinancial.com	UT1-Finance
expedia.com	Chris-Whitelist
experian.com	Adguard-Sensitive-White
f-cdn.com	Adguard-Sensitive-White
f-secure.com	Adguard-Sensitive-White
facebook.com	Chris-Whitelist, Pi-DNS
fairfx.com	Adguard-Banks-White
familyds.com	Adguard-Sensitive-White
farmersebank.com	Adguard-Banks-White
www.fasbd.com	Adguard-Banks-White
fast.com	Chris-Whitelist
fastbill.com	Adguard-Banks-White
fastmail.com	Adguard-Sensitive-White
fat-cash.com	UT1-Finance
fatpitchfinancials.com	UT1-Finance
fbtonline.com	Adguard-Banks-White
fbwebpos.com	Adguard-Banks-White
federatedfinancial.com	UT1-Finance
fednetbank.com	Adguard-Banks-White
feniciabank.com	Adguard-Banks-White
feoquizserver.com	Adguard-Android-White
www.ffilbd.com	Adguard-Banks-White
fidelity.com	Adguard-Banks-White
financial-calculators.com	UT1-Finance
financial-cents.com	UT1-Finance
financial-data.com	UT1-Finance
financial-edu.com	UT1-Finance
financial-field.com	UT1-Finance
financial-net.com	UT1-Finance
financial-planning.com	UT1-Finance
financial-remedies.com	UT1-Finance
financial-spread-betting.com	UT1-Finance
financial-strategy.com	UT1-Finance
financial-warrior.com	UT1-Finance
financialadvisordraper.com	UT1-Finance
financialadvisorincleveland.com	UT1-Finance
financialadvisoriq.com	UT1-Finance
financialafrik.com	UT1-Finance
financialaidfinder.com	UT1-Finance
financialaidtv.com	UT1-Finance
financialarmageddon.com	UT1-Finance
financialbestlife.com	UT1-Finance
financialbuzz.com	UT1-Finance
financialcenter.com	UT1-Finance
financialcontent.com	UT1-Finance
financialcryptography.com	UT1-Finance
financialengines.com	UT1-Finance
financialexpress.com	UT1-Finance
financialexpress-bd.com	UT1-Finance
financialfinesse.com	UT1-Finance
financialfootball.com	UT1-Finance
financialforce.com	UT1-Finance
financialfreedomcountdown.com	UT1-Finance
financialfundrecovery.com	UT1-Finance
financialgym.com	UT1-Finance
financialhearings.com	UT1-Finance
financialhelpdesk.com	UT1-Finance
financialhighway.com	UT1-Finance
financialhorse.com	UT1-Finance
financialmentor.com	UT1-Finance
financialmirror.com	UT1-Finance
financialmodelingprep.com	UT1-Finance
financialmonopoly.com	UT1-Finance
financialnewsmedia.com	UT1-Finance
financialnut.com	UT1-Finance
financialopticshq.com	UT1-Finance
financialounge.com	UT1-Finance
financialpanther.com	UT1-Finance
financialpeace.com	UT1-Finance
financialpipeline.com	UT1-Finance
financialplan2u.com	UT1-Finance
financialplannerla.com	UT1-Finance
financialpoise.com	UT1-Finance
financialpost.com	UT1-Finance
financialred.com	UT1-Finance
financialregnews.com	UT1-Finance
financialresidency.com	UT1-Finance
financialsamurai.com	UT1-Finance
financialsecrecyindex.com	UT1-Finance
financialsense.com	UT1-Finance
financialsurvivalnetwork.com	UT1-Finance
financialtrans.com	UT1-Finance
financialtribune.com	UT1-Finance
financialwatches.com	UT1-Finance
financialwatchngr.com	UT1-Finance
financialweek.com	UT1-Finance
financialwolves.com	UT1-Finance
finansonline.com	Adguard-Banks-White
finaperf.com	UT1-Finance
findicons.com	Chris-Whitelist
finecobank.com	Adguard-Banks-White
firebaseapp.com	Chris-Whitelist
detectportal.firefox.com	Chris-Connect
firstbankcard.com	Adguard-Banks-White
fitbit.com	Chris-Whitelist
fitbitdevelopercontent.com	Chris-Whitelist
fleetfinancials.com	UT1-Finance
fletchfinancial.com	UT1-Finance
mapi.flypgs.com	Adguard-Android-White
fnbba.com	Adguard-Banks-White
focusfinancialpartners.com	UT1-Finance
forafinancial.com	UT1-Finance
force.com	Chris-Whitelist
mybank.fortebank.com	Adguard-Banks-White
online.fortebank.com	Adguard-Banks-White
fortressfinancialstrategies.com	UT1-Finance
online.forward-bank.com	Adguard-Banks-White
fosterswiss.com	Adguard-Banks-White
profile.franklintempleton.com	Adguard-Issues-White
freakymoney.com	UT1-Finance
freedomfinancialcredit.com	UT1-Finance
freedomfinancialnetwork.com	UT1-Finance
freelancer.com	Adguard-Sensitive-White
api.freeletics.com	Adguard-Android-White
freshbooks.com	Adguard-Sensitive-White
frostbank.com	Adguard-Banks-White
fsecurify.com	Chris-Whitelist
cloud.fsiblbd.com	Adguard-Banks-White
www.fsiblbd.com	Adguard-Banks-White
fsibplc.com	Adguard-Banks-White
ftx.com	Adguard-Banks-White
fubon.com	Adguard-Banks-White
fuelrewards.com	Chris-Whitelist
acs.fuib.com	Adguard-Banks-White
pps.fuib.com	Adguard-Banks-White
service.fuib.com	Adguard-Banks-White
furongfinancial.com	UT1-Finance
exchange.futureswap.com	Adguard-Banks-White
secure.gate2shop.com	Adguard-Banks-White
gfwsl.geforce.com	AnuDeep
exchange.gemini.com	Adguard-Banks-White
getpenta.com	Adguard-Banks-White
ggpht.com	Chris-Whitelist
gigsky.com	Chris-Whitelist
giphy.com	AnuDeep
github.com	Chris-Whitelist, AnuDeep
githubapp.com	Chris-Whitelist
githubusercontent.com	Chris-Whitelist
gitlab.com	Chris-Whitelist
glassdoor.com	Chris-Whitelist
globalfinancialdata.com	UT1-Finance
globalhbl.com	Adguard-Banks-White
www.globalislamibankbd.com	Adguard-Banks-White
exchange.globitex.com	Adguard-Banks-White
api.gm.com	Adguard-Android-White
gmmobileservices.gm.com	Adguard-Android-White
gmail.com	Chris-Whitelist
gmfinancial.com	UT1-Finance
go.com	Chris-Whitelist
godlyfinancial.com	UT1-Finance
goodfinancialcents.com	UT1-Finance
goodstewardfinancialco.com	UT1-Finance
accounts.google.com	Adguard-Sensitive-White
0.client-channel.google.com	AnuDeep
clients.google.com	Chris-Whitelist
clients1.google.com	Chris-Whitelist, AnuDeep
clients2.google.com	Chris-Whitelist, AnuDeep
clients3.google.com	Chris-Whitelist, Chris-Connect, AnuDeep
clients4.google.com	Chris-Whitelist, AnuDeep
clients5.google.com	Chris-Whitelist, AnuDeep
clients6.google.com	Chris-Whitelist, AnuDeep
clients7.google.com	Chris-Whitelist
clients8.google.com	Chris-Whitelist
clients9.google.com	Chris-Whitelist
console.cloud.google.com	Adguard-Issues-White
ssh.cloud.google.com	Adguard-Issues-White
cse.google.com	AnuDeep
appspot-preview.l.google.com	AnuDeep
googleapis.l.google.com	Chris-Whitelist
video-stats.l.google.com	AnuDeep
mail.google.com	Chris-Whitelist
meet.google.com	Adguard-Issues-White
mtalk.google.com	Chris-Connect
pay.google.com	Adguard-Banks-White
www.google.com	Chris-Connect
googleapis.com	AnuDeep
googlecode.com	Chris-Whitelist
googleusercontent.com	Chris-Whitelist
manifest.googlevideo.com	Chris-Whitelist, AnuDeep
redirector.googlevideo.com	AnuDeep
3dsecure.gpwebpay.com	Adguard-Banks-White
grabtaxi.com	Adguard-Android-White
gravatar.com	AnuDeep
greenlightfinancial.com	UT1-Finance
greensill-bank.com	Adguard-Banks-White
greenwheels.com	Chris-Whitelist
grenkeonline.com	Adguard-Banks-White
boursorama.groupe-credit-du-nord.com	UT1-Finance
grupobancolombia.com	Adguard-Banks-White
webid2.gs.com	Adguard-Banks-White
www.gspfinance.com	Adguard-Banks-White
gstatic.com	AnuDeep
gtbank.com	Adguard-Banks-White
guestcash.com	UT1-Finance
guidantfinancial.com	UT1-Finance
guidestonefinancialgroup.com	UT1-Finance
gunaybank.com	Adguard-Banks-White
gvt1.com	Chris-Whitelist
gvt2.com	Chris-Whitelist
api.hackertarget.com	Chris-Whitelist
halofinancial.com	UT1-Finance
hanabank.com	Adguard-Banks-White
hangseng.com	Adguard-Banks-White
harrisbank.com	Adguard-Banks-White
harrisfinancialprosperityadvisor.com	UT1-Finance
www.ibank.hbl.com	Adguard-Banks-White
hdfcbank.com	Adguard-Banks-White
web.hellenicbank.com	Adguard-Banks-White
hellenicnetbanking.com	Adguard-Banks-White
hellostake.com	Adguard-Banks-White
api.here.com	Adguard-Android-White
data.here.com	Adguard-Android-White
hitbtc.com	Adguard-Banks-White
hlebroking.com	Adguard-Banks-White
holvi.com	Adguard-Banks-White
homepointfinancial.com	UT1-Finance
hondafinancialservices.com	UT1-Finance
mail.hostmonster.com	Adguard-Issues-White
hpcloud.hp.com	Adguard-Issues-White
hpcgalleries.com	UT1-Finance
hrblock.com	Adguard-Sensitive-White, Pi-DNS
hsbc.com	Adguard-Banks-White
hsbcnet.com	Adguard-Banks-White
hsbcprivatebank.com	Adguard-Banks-White
hubank.com	Adguard-Banks-White
hubbardfinancial.com	UT1-Finance
hubspot.com	Chris-Whitelist
huntington.com	Adguard-Banks-White
hvsfinancial.com	UT1-Finance
ibanking-services.com	Adguard-Banks-White
www.icbislamic-bd.com	Adguard-Banks-White
icicibank.com	Adguard-Banks-White
icloud.com	Chris-Whitelist, Adguard-Mac-White
icloud-content.com	Chris-Whitelist
icon25-bank.com	Adguard-Banks-White
idbi.com	Adguard-Banks-White
idbibank.com	Adguard-Banks-White
www.idlc.com	Adguard-Banks-White
idnfinancials.com	UT1-Finance
idnotify.com	Adguard-Sensitive-White
idwatchdog.com	Adguard-Sensitive-White
www.ifilbd.com	Adguard-Banks-White
ifinancialguide.com	UT1-Finance
iforex.com	UT1-Finance
ifttt.com	Chris-Whitelist
igcdn.com	Chris-Whitelist
checkout.iherb.com	Adguard-Banks-White
www.iidfc.com	Adguard-Banks-White
sube.iktisatbank.com	Adguard-Banks-White
www.ilfsl.com	Adguard-Banks-White
inc.com	Chris-Whitelist
independentreserve.com	Adguard-Banks-White
inetpayonline.com	Adguard-Banks-White
ing.com	Chris-Whitelist
ingonline.com	Adguard-Banks-White
ingwb.com	Adguard-Banks-White
inicis.com	Adguard-Banks-White
insiderfinancial.com	UT1-Finance
insitefinancialcu.com	UT1-Finance
inspirafinancial.com	UT1-Finance
instafinancials.com	UT1-Finance
instagram.com	Chris-Whitelist
instamojo.com	Adguard-Banks-White
instapaper.com	Adguard-Android-White
instinctmoney.com	UT1-Finance
intel.com	Chris-Whitelist
interactivebrokers.com	Adguard-Banks-White
internetpanin.com	Adguard-Banks-White
paygate.intersecurepayment.com	UT1-Finance
intesasanpaolo.com	Adguard-Banks-White
intuit.com	Chris-Whitelist, UT1-Finance
invensys.com	Chris-Whitelist
investfinancialservices.com	UT1-Finance
www.ipdcbd.com	Adguard-Banks-White
ipdeny.com	Chris-Whitelist
i.ipotekabank.com	Adguard-Banks-White
secure.ipsp.com	Adguard-Banks-White
irafinancialgroup.com	UT1-Finance
www.islamibankbd.com	Adguard-Banks-White
itffinancial.com	UT1-Finance
bourse.ivisite.com	UT1-Finance
jago.com	Adguard-Banks-White
www.jamunabankbd.com	Adguard-Banks-White
www.janatabank-bd.com	Adguard-Banks-White
bourse.jdf.com	UT1-Finance
jenius.com	Adguard-Banks-White
jkopay.com	Adguard-Banks-White
johnsonfinancial.com	UT1-Finance
johnsonfinancialgroup.com	UT1-Finance
johnthomasfinancial.com	UT1-Finance
jquery.com	AnuDeep
juliusbaer.com	Adguard-Banks-White
justworks.com	Chris-Whitelist
jwpcdn.com	Chris-Whitelist
kahlerfinancial.com	UT1-Finance
ac-talk.kakao.com	Adguard-Android-White
accounts.kakao.com	Adguard-Sensitive-White
api.kakao.com	Adguard-Android-White
channel.kakao.com	Adguard-Android-White
clog-aggregator.kakao.com	Adguard-Android-White
gift.kakao.com	Adguard-Android-White
item.kakao.com	Adguard-Android-White
katalk.kakao.com	Adguard-Android-White
kauth.kakao.com	Adguard-Sensitive-White
pf-api.kakao.com	Adguard-Android-White
talk.kakao.com	Adguard-Android-White
kaplanfinancial.com	UT1-Finance
kashflow.com	Adguard-Sensitive-White
online.kasikornbankgroup.com	Adguard-Banks-White
kbstar.com	Adguard-Banks-White
kebhana.com	Adguard-Banks-White
correqts.kedrbank.com	Adguard-Banks-White
key.com	Adguard-Banks-White
kgibank.com	Adguard-Banks-White
kingsfinancialconsulting.com	UT1-Finance
klarna.com	Adguard-Banks-White
klikbca.com	Adguard-Banks-White
knoxfinancial.com	UT1-Finance
kokobank.com	Adguard-Banks-White
kontist.com	Adguard-Banks-White
secure.koopbank.com	Adguard-Banks-White
kpn.com	Chris-Whitelist
kraken.com	Adguard-Banks-White
kreditprombank.com	Adguard-Banks-White
krungsri.com	Adguard-Banks-White
krungsribizonline.com	Adguard-Banks-White
krungsrionline.com	Adguard-Banks-White
fido.kt.com	Adguard-Sensitive-White
login.kt.com	Adguard-Sensitive-White
ktbnetbank.com	Adguard-Banks-White
kuaidi100.com	Pi-DNS
kucoin.com	Adguard-Banks-White
kwiatfinancial.com	UT1-Finance
lanefinancialstrategies.com	UT1-Finance
www.lankabangla.com	Adguard-Banks-White
www.lankanalliance.com	Adguard-Banks-White
lastpass.com	Chris-Whitelist, Adguard-Android-White, Adguard-Sensitive-White
latestusfinancialnews.com	UT1-Finance
lattice.com	Chris-Whitelist
leboutique.com	Adguard-Banks-White
legalandgeneral.com	Adguard-Banks-White
lendmarkfinancial.com	UT1-Finance
leomoney.com	Adguard-Banks-White
bourse.lerevenu.com	UT1-Finance
lexusfinancial.com	UT1-Finance
lgappstv.com	Pi-DNS
lgbbank.com	Adguard-Banks-White
libertyloansfinancial.com	UT1-Finance
traffic.libsyn.com	AnuDeep
licdn.com	Chris-Whitelist
customer.lichousing.com	Adguard-Banks-White
lifelock.com	Adguard-Sensitive-White
lincolnfinancial.com	UT1-Finance
lincolnfinancialfield.com	UT1-Finance
voipnx-saturn.line-apps.com	Adguard-Issues-White
linkedin.com	Chris-Whitelist
liqpay.com	Adguard-Banks-White
live.com	AnuDeep
liztonfinancialcorporation.com	UT1-Finance
lloydsbank.com	Adguard-Banks-White
localbitcoins.com	Adguard-Banks-White
localethereum.com	Adguard-Banks-White
lovecitybrewing.com	Chris-Whitelist
lzo.com	Adguard-Banks-White
m1finance.com	Adguard-Banks-White
mackenziefinancial.com	UT1-Finance
madridfinancialsolutions.com	UT1-Finance
mailfence.com	Adguard-Sensitive-White
makebling.com	UT1-Finance
malwaredomainlist.com	Chris-Whitelist
malwaredomains.com	Chris-Whitelist
mapbox.com	Chris-Whitelist
marcus.com	Adguard-Banks-White
maritimebank.com	Adguard-Banks-White
s.marketwatch.com	AnuDeep
masterpass.com	Adguard-Banks-White
ziraatyatirim.matrikswebtrader.com	Adguard-Banks-White
maxmind.com	Chris-Whitelist
ibank.mbbru.com	Adguard-Banks-White
mbfinancial.com	UT1-Finance
www.mblbd.com	Adguard-Banks-White
avts.mcafee.com	Chris-Whitelist
mob2api.mdc53.com	Adguard-Android-White
e-plat.mdmbank.com	Adguard-Banks-White
meabank.com	Adguard-Banks-White
meansfinancial.com	UT1-Finance
mebytmb.com	Adguard-Banks-White
media-amazon.com	Chris-Whitelist
api.meetme.com	Adguard-Android-White
meltwater.com	Chris-Whitelist
mercantilbanco.com	Adguard-Banks-White
www.meridianfinancebd.com	Adguard-Banks-White
merrilledge.com	Chris-Whitelist
mesirowfinancial.com	UT1-Finance
messagelabs.com	Chris-Whitelist
personal.metrobankdirect.com	Adguard-Banks-White
metzler.com	Adguard-Banks-White
mexc.com	Adguard-Sensitive-White
browser.pipe.aria.microsoft.com	Chris-Whitelist
mobile.pipe.aria.microsoft.com	Chris-Whitelist
api.cognitive.microsoft.com	Adguard-Android-White
v10.events.data.microsoft.com	Chris-Whitelist
settings-win.data.microsoft.com	Chris-Whitelist
continuum.dds.microsoft.com	AnuDeep
win10.ipv6.microsoft.com	AnuDeep
xbox.ipv6.microsoft.com	AnuDeep
dl.delivery.mp.microsoft.com	AnuDeep
displaycatalog.mp.microsoft.com	AnuDeep
geo-prod.do.dsp.mp.microsoft.com	AnuDeep
officecdn.microsoft.com	Chris-Whitelist
officeclient.microsoft.com	Chris-Whitelist, AnuDeep
microsoftonline.com	AnuDeep
mint.com	UT1-Finance
mintcofinancial.com	UT1-Finance
mis34.com	UT1-Finance
ml.com	Adguard-Banks-White
mobikwik.com	Adguard-Banks-White
modhumotibankltd.com	Adguard-Banks-White
acs2.3ds.modirum.com	Adguard-Banks-White
acs2.rosbank.modirum.com	Adguard-Banks-White
mohela.com	Adguard-Banks-White
monese.com	Adguard-Banks-White
global.moneygram.com	Adguard-Banks-White
monster.com	Chris-Whitelist
monzo.com	Adguard-Banks-White
my.morskoybank.com	Adguard-Banks-White
mrbillfinancial.com	UT1-Finance
mrfinancialindependence.com	UT1-Finance
msftconnecttest.com	Chris-Whitelist, Chris-Connect
msftncsi.com	Chris-Whitelist, Chris-Connect, AnuDeep
otf.msn.com	Adguard-Android-White
msnbc.com	Chris-Whitelist
mtochka.com	Adguard-Banks-White
www.mutualtrustbank.com	Adguard-Banks-White
keystone.mwbsys.com	AnuDeep
pay.my.com	Adguard-Banks-White
mydocomo.com	Adguard-Sensitive-White
myetherwallet.com	Adguard-Banks-White
myfinancialscorecard.com	UT1-Finance
mymerrill.com	Adguard-Banks-White
myob.com	Adguard-Sensitive-White
myvoba.com	Adguard-Banks-White
mzstatic.com	Chris-Whitelist, Adguard-Mac-White
n26.com	Adguard-Banks-White
narvar.com	Chris-Whitelist
www.nationalhousingbd.com	Adguard-Banks-White
mybank.nationstrust.com	Adguard-Banks-White
nationwidefinancial.com	UT1-Finance
natwest.com	Adguard-Banks-White
nid.naver.com	Adguard-Sensitive-White
pay.naver.com	Adguard-Sensitive-White
nbcnews.com	Chris-Whitelist
nbcuas.com	Chris-Whitelist
nbcuni.com	Chris-Whitelist
nbcuniversal.com	Chris-Whitelist
www.nblbd.com	Adguard-Banks-White
www.neosonline.ndbbank.com	Adguard-Banks-White
www.ndbbankonline.com	Adguard-Banks-White
portal.nefteprom.com	Adguard-Banks-White
neofinancial.com	UT1-Finance
nespresso.com	Chris-Whitelist
nest.com	Chris-Whitelist, Adguard-Issues-White
neteller.com	Adguard-Banks-White
netflix.com	Chris-Whitelist
netgear.com	Chris-Whitelist
netpnb.com	Adguard-Banks-White
netteller.com	Adguard-Banks-White
nextdoor.com	Chris-Whitelist
nflxext.com	Chris-Whitelist
no-ip.com	AnuDeep
nonghyup.com	Adguard-Banks-White
digital.noorbank.com	Adguard-Banks-White
nordea.com	Adguard-Banks-White
nordpass.com	Adguard-Sensitive-White
northcoastfinancialinc.com	UT1-Finance
www.nrbbankbd.com	Adguard-Banks-White
www.nrbcommercialbank.com	Adguard-Banks-White
ns1.com	Chris-Whitelist
nsandi.com	Adguard-Banks-White
nucleusfinancial.com	UT1-Finance
nwolb.com	Adguard-Banks-White
o-bank.com	Adguard-Banks-White
internet.ocbc.com	Adguard-Banks-White
newvelocity.ocbcnisp.com	Adguard-Banks-White
online.ocbcnisp.com	Adguard-Banks-White
oddo-bhf.com	Adguard-Banks-White
office.com	AnuDeep
office365.com	Chris-Whitelist, AnuDeep
ogone.com	Chris-Whitelist
secure.okpay.com	Adguard-Banks-White
payments.olx.com	Adguard-Banks-White
oneaccount.com	Adguard-Banks-White
www.onebankbd.com	Adguard-Banks-White
onefinancialmarkets.com	UT1-Finance
onemainfinancial.com	UT1-Finance
onfastspring.com	Adguard-Banks-White
onlinebanking-ibb-ag.com	Adguard-Banks-White
www.onlinesbiglobal.com	Adguard-Banks-White
schneiderelectric.mail.onmicrosoft.com	Chris-Whitelist
onpointcu.com	Adguard-Sensitive-White
onqfinancial.com	UT1-Finance
opendns.com	Chris-Whitelist
openmultipleurl.com	Chris-Whitelist
openphish.com	Chris-Whitelist
sitecheck1.opera.com	Adguard-Issues-White
sitecheck2.opera.com	Adguard-Issues-White
sitecheck3.opera.com	Adguard-Issues-White
sitecheck4.opera.com	Adguard-Issues-White
sitecheck5.opera.com	Adguard-Issues-White
sitecheck6.opera.com	Adguard-Issues-White
sitecheck7.opera.com	Adguard-Issues-White
wallpaperapi.sofa.opera-api2.com	Adguard-Android-White
api.oplata.com	Adguard-Banks-White
cdn.optimizely.com	AnuDeep
cdn2.optimizely.com	AnuDeep
cdn3.optimizely.com	AnuDeep
optumbank.com	Adguard-Banks-White
oschad24.com	Adguard-Banks-White
3ds.oschadnybank.com	Adguard-Banks-White
outlook.com	Chris-Whitelist
ovmfinancial.com	UT1-Finance
oxygenfinancial.com	UT1-Finance
online.pabcbank.com	Adguard-Banks-White
checkout.paddle.com	Adguard-Banks-White
www.padmabankbd.com	Adguard-Banks-White
pagbrasil.com	Adguard-Banks-White
papara.com	Adguard-Banks-White, Adguard-Sensitive-White
trade.paritem.com	Adguard-Banks-White
payco.com	Adguard-Banks-White
payeer.com	Adguard-Banks-White
paykun.com	Adguard-Banks-White
secure.payler.com	Adguard-Banks-White
myaccount.payoneer.com	Adguard-Banks-White
payonlinesystem.com	Adguard-Banks-White
paypal.com	Adguard-Banks-White
paypal-nakit.com	Adguard-Banks-White
paypalobjects.com	Adguard-Banks-White
payproglobal.com	Adguard-Banks-White
paytm.com	Adguard-Banks-White
paytr.com	Adguard-Banks-White
payture.com	Adguard-Banks-White
secure.payu.com	Adguard-Banks-White
secure.payza.com	Adguard-Banks-White
pbbdirekt.com	Adguard-Banks-White
pbebank.com	Adguard-Banks-White
pcbac.com	Adguard-Banks-White
peapod.com	Chris-Whitelist
pelco.com	Chris-Whitelist
new.permatanet.com	Adguard-Banks-White
personal-financial-officer.com	UT1-Finance
philips.com	Chris-Whitelist
data.phishtank.com	Chris-Whitelist
control.phone.com	Adguard-Issues-White
pi-dns.com	Pi-DNS
picnicinternational.com	Chris-Whitelist
picpay.com	Adguard-Banks-White
pictet.com	Adguard-Banks-White
piraeusbank.com	Adguard-Banks-White
plategka.com	Adguard-Banks-White
secure.platononline.com	Adguard-Banks-White
my.plexapp.com	AnuDeep
node.plexapp.com	AnuDeep
nine.plugins.plexapp.com	AnuDeep
tvthemes.plexapp.com	AnuDeep
www.plfsbd.com	Adguard-Banks-White
plimus.com	Adguard-Banks-White
pnc.com	Adguard-Banks-White
pocketnow.com	Pi-DNS
portaldepagosmercantil.com	Adguard-Banks-White
bank.postil.com	Adguard-Banks-White
full.pr0gramm.com	Pi-DNS
www.premierbankltd.com	Adguard-Banks-White
prepaidfinancialservices.com	UT1-Finance
www.primefinancebd.com	Adguard-Banks-White
priovtb.com	Adguard-Banks-White
privatbank1891.com	Adguard-Banks-White
productplan.com	Chris-Whitelist
profitplusfinancial.com	UT1-Finance
prosperitybankusa.com	Adguard-Banks-White
protonmail.com	Adguard-Sensitive-White
protonvpn.com	Adguard-Sensitive-White
providencejournal.com	Chris-Whitelist
bbvaprovinet.provincial.com	Adguard-Banks-White
prozonfinancials.com	UT1-Finance
psafinancial.com	UT1-Finance
ibank2.pskb.com	Adguard-Banks-White
www.pubalibangla.com	Adguard-Banks-White
purefinancial.com	UT1-Finance
pushwoosh.com	Chris-Whitelist
pxpayplus.com	Adguard-Banks-White
pxpfinancial.com	UT1-Finance
qantasmoney.com	Adguard-Banks-White
qiwi.com	Adguard-Banks-White
qnb.com	Adguard-Banks-White
ib.qnbalahli.com	Adguard-Banks-White
qnbfinansbank.com	Adguard-Banks-White
vd.l.qq.com	Adguard-Sensitive-White
qweb.quercia.com	Adguard-Banks-White
questrade.com	Adguard-Banks-White
quizup.com	Adguard-Android-White
radiotime.com	Chris-Whitelist
moj.raiffeisenpolbank.com	Adguard-Banks-White
raonsecure.com	Adguard-Sensitive-White
razorpay.com	Adguard-Banks-White
rbcroyalbank.com	Adguard-Banks-White
rblbank.com	Adguard-Banks-White
rbsdigital.com	Adguard-Banks-White
rbsinternational.com	Adguard-Banks-White
rcbconline-corporate.com	Adguard-Banks-White
rcbconlinebanking.com	Adguard-Banks-White
reachfinancialindependence.com	UT1-Finance
realgrowthfinancial.com	UT1-Finance
receiptbank.com	Adguard-Sensitive-White
rehabfinancial.com	UT1-Finance
renewfinancial.com	UT1-Finance
renmarkfinancial.com	UT1-Finance
revolut.com	Chris-Whitelist, Adguard-Banks-White
rfcu.com	Adguard-Banks-White
onlinebanking.rhbgroup.com	Adguard-Banks-White
riafinancial.com	UT1-Finance
ib.ribbank.com	Adguard-Banks-White
ibank.ricbank.com	Adguard-Banks-White
ibankr.ricbank.com	Adguard-Banks-White
richardfinancial.com	UT1-Finance
richfinancialplanner.com	UT1-Finance
riyadbank.com	Adguard-Banks-White
robinhood.com	Adguard-Banks-White
roboform.com	Adguard-Sensitive-White
rbaccess.rogersbank.com	Adguard-Banks-White
ibc.roscap.com	Adguard-Banks-White
secure.royalbank.com	Adguard-Banks-White
www1.royalbank.com	Adguard-Banks-White
widget-cdn.rpxnow.com	AnuDeep
rt.com	Chris-Whitelist
rusnarbank.com	Adguard-Banks-White
russobank.com	Adguard-Banks-White
c.s-microsoft.com	AnuDeep
s-nbcnews.com	Chris-Whitelist
sabb.com	Adguard-Banks-White
saferpay.com	Adguard-Banks-White
salesforce.com	Chris-Whitelist
samba.com	Adguard-Banks-White
samknows.com	Chris-Whitelist
samknows-cdn.com	Chris-Whitelist
sampathvishwa.com	Adguard-Banks-White
atlas.samsung.com	Adguard-Android-White
isu-odc.samsungapps.com	Adguard-Android-White
vas.samsungapps.com	Adguard-Android-White
api.samsungcloud.com	Adguard-Issues-White
samsungosp.com	Adguard-Android-White
samsungpop.com	Adguard-Banks-White
santanderbank.com	Adguard-Banks-White
gws.sauberbank.com	Adguard-Banks-White
www.sbacbank.com	Adguard-Banks-White
sberbank.com	Adguard-Banks-White
sbicard.com	Adguard-Banks-White
sbiepay.com	Adguard-Banks-White
sbitfinancial.com	UT1-Finance
sc.com	Adguard-Banks-White
scbeasy.com	Adguard-Banks-White
schneider-electric.com	Chris-Whitelist
schwab.com	Adguard-Banks-White
scotiabank.com	Adguard-Banks-White
scottishfinancialnews.com	UT1-Finance
webapp.sebgroup.com	Adguard-Banks-White
sec-tunnel.com	Adguard-Issues-White
secuchart.com	Adguard-Sensitive-White
secureinternetbank.com	Adguard-Banks-White
securesafe.com	Adguard-Sensitive-White
securitybank.com	Adguard-Banks-White
sefinancial.com	UT1-Finance
secure4.segpay.com	Adguard-Banks-White
sendfromchina.com	Chris-Whitelist
sendwyre.com	Adguard-Banks-White
settrade.com	Adguard-Banks-White
sex1950.com	UT1-Finance
www.sfilbd.com	Adguard-Banks-White
beta.shapeshift.com	Adguard-Banks-White
sharesight.com	Adguard-Banks-White
sheffieldfinancial.com	UT1-Finance
shfinancialnews.com	UT1-Finance
www.shimantobank.com	Adguard-Banks-White
shinhan.com	Adguard-Banks-White
kz.shinhanglobal.com	Adguard-Banks-White
shinseibank.com	Adguard-Banks-White
www.siblbd.com	Adguard-Banks-White
cb1.sichbank.com	Adguard-Banks-White
signicat.com	Adguard-Banks-White
api.simperium.com	Adguard-Android-White
auth.simperium.com	Adguard-Android-White
simple.com	Adguard-Banks-White
simplefinanciallifestyle.com	UT1-Finance
simplii.com	Adguard-Banks-White
sinopac.com	Adguard-Banks-White
static.siteheart.com	Adguard-Banks-White
www.sjiblbd.com	Adguard-Banks-White
account.skrill.com	Adguard-Banks-White
pay.skrill.com	Adguard-Banks-White
skype.com	Chris-Whitelist
slack.com	Chris-Whitelist
smartcomparisons.com	UT1-Finance
smartfinancial.com	UT1-Finance
smartsheet.com	Chris-Whitelist
societegenerale.com	Adguard-Banks-White
static.reverse.softlayer.com	Chris-Whitelist
sonos.com	Chris-Whitelist
sophos.com	Adguard-Sensitive-White
sorexpay.com	Adguard-Banks-White
southindianbank.com	Adguard-Banks-White
spectrocoin.com	Adguard-Banks-White
splashfinancial.com	UT1-Finance
spotify.com	Chris-Whitelist
squaredfinancial.com	UT1-Finance
squarespace.com	Chris-Whitelist
ssl-images-amazon.com	Chris-Whitelist
sslcommerz.com	Adguard-Banks-White
stats.stackexchange.com	MMoti
stairsfinancial.com	UT1-Finance
stamasfinancial.com	UT1-Finance
stanbicibtcbank.com	Adguard-Banks-White
www.standardbankbd.com	Adguard-Banks-White
ae.online.standardchartered.com	Adguard-Banks-White
s2b.standardchartered.com	Adguard-Banks-White
www.standardchartered.com	Adguard-Banks-White
online.standardlife.com	Adguard-Banks-White
starfinancial.com	UT1-Finance
starlingbank.com	Adguard-Banks-White
start2pay.com	Adguard-Banks-White
startmail.com	Adguard-Issues-White
stopandshop.com	Chris-Whitelist
stopforumspam.com	Chris-Whitelist
stradafinancial.com	UT1-Finance
strictly-financial.com	UT1-Finance
stripe.com	Adguard-Banks-White
sunlightfinancial.com	UT1-Finance
api.surfeasy.com	Adguard-Issues-White
secure.surveymonkey.com	AnuDeep
productserver.sygic.com	Adguard-Android-White
sa.symcb.com	AnuDeep
symphonis.com	UT1-Finance
redir.diamond.synacor.com	Pi-DNS
synchronyfinancial.com	UT1-Finance
synthesisbank.com	UT1-Finance
tac.com	Chris-Whitelist
talosintel.com	Chris-Whitelist
talpanetwork.com	Chris-Whitelist
td.com	Adguard-Banks-White
tdameritrade.com	Adguard-Banks-White
tdbank.com	Adguard-Banks-White
tdcanadatrust.com	Adguard-Banks-White
tech1-cdn.com	Adguard-Android-White
tech2-cdn.com	Adguard-Android-White
online.techcu.com	Adguard-Banks-White
app-api.ted.com	AnuDeep
hls.ted.com	AnuDeep
tedcdn.com	AnuDeep
termius.com	Adguard-Sensitive-White
tescobank.com	Adguard-Banks-White
thalys.com	Chris-Whitelist
thalysnet.com	Chris-Whitelist
www.thecitybank.com	Adguard-Banks-White
thefinancialblaze.com	UT1-Finance
thefinancialbrand.com	UT1-Finance
thefinancialdaily.com	UT1-Finance
thefinancialdiet.com	UT1-Finance
thefinancialexpress-bd.com	UT1-Finance
thefinancialgeek.com	UT1-Finance
thefinancialist.com	UT1-Finance
thefinancials.com	UT1-Finance
thefinancialtechnologyreport.com	UT1-Finance
thefreefinancialadvisor.com	UT1-Finance
theinstapay.com	Adguard-Banks-White
theluckygene.com	Adguard-Issues-White
themoviedb.com	AnuDeep
thetvdb.com	AnuDeep
thisissand.com	Adguard-Android-White
tiltedbarnbrewery.com	Chris-Whitelist
tinyurl.com	Chris-Whitelist, AnuDeep
tiscoasset.com	Adguard-Banks-White
titanvest.com	Adguard-Banks-White
tmbdirect.com	Adguard-Banks-White
tns-nipo.com	Chris-Whitelist
tochka.com	Adguard-Banks-White
tomtom.com	Chris-Whitelist
tossbank.com	Adguard-Banks-White
tossinvest.com	Adguard-Banks-White
touchbank.com	Adguard-Banks-White
toyotafinancial.com	UT1-Finance
trader-workstation.com	UT1-Finance
app.traderepublic.com	Adguard-Sensitive-White
transaccionesbancolombia.com	Adguard-Banks-White
transamerica.com	Adguard-Banks-White
ibank.transcapital.com	Adguard-Banks-White
transferwise.com	Chris-Whitelist
transunion.com	Adguard-Sensitive-White
trbinance.com	Adguard-Sensitive-White
ib.troikabank.com	Adguard-Banks-White
trueidentity.com	Adguard-Sensitive-White
truelinkfinancial.com	UT1-Finance
trulyfinancial.com	UT1-Finance
truoptik.com	UT1-Finance
trustarc.com	UT1-Finance
truste.com	UT1-Finance
trustedid.com	Adguard-Sensitive-White
api.tumblr.com	Adguard-Android-White
media.tumblr.com	Adguard-Android-White
static.tumblr.com	Adguard-Android-White
vt.tumblr.com	Adguard-Android-White
tunein.com	Chris-Whitelist
turbotax.com	Chris-Whitelist
bireysel.turkishbank.com	Adguard-Banks-White
esube.turkishbank.com	Adguard-Banks-White
kurumsal.turkishbank.com	Adguard-Banks-White
esube.turkishcards.com	Adguard-Banks-White
isube.turkishyatirim.com	Adguard-Banks-White
tutanota.com	Adguard-Sensitive-White
tutotoons.com	Adguard-Android-White
twimg.com	AnuDeep
dino.tzero.com	Adguard-Banks-White
ubinco.com	Adguard-Banks-White
ubs.com	Adguard-Banks-White
start.ubuntu.com	Chris-Connect
ikb.uci-bank.com	Adguard-Banks-White
g.udimg.com	Pi-DNS
ukrgasbank.com	Adguard-Banks-White
ukrsibbank.com	Adguard-Banks-White
ibank.ukrsotsbank.com	Adguard-Banks-White
www.unicap-bd.com	Adguard-Banks-White
unionbank.com	Adguard-Banks-White
unionbankph.com	Adguard-Banks-White
united1stfinancial.com	UT1-Finance
th.bibplus.uobgroup.com	Adguard-Banks-White
pib.uobthailand.com	Adguard-Banks-White
uphold.com	Adguard-Banks-White
dbo1.uralfinance.com	Adguard-Banks-White
urbanairship.com	Adguard-Android-White
urlblacklist.com	Chris-Whitelist
usaa.com	Adguard-Banks-White
onlinebanking.usbank.com	Adguard-Banks-White
userapi.com	Adguard-Android-White
usfinancialnewstoday.com	UT1-Finance
usvisa-info.com	Chris-Whitelist
www.uttarabank-bd.com	Adguard-Banks-White
vakifbankusa.com	Adguard-Banks-White
vancity.com	Adguard-Banks-White
vanderbiltfinancial.com	UT1-Finance
vanguard.com	Adguard-Banks-White
vol.venezolano.com	Adguard-Banks-White
venmo.com	Adguard-Banks-White
vesperexchange.com	UT1-Finance
api.viber.com	Adguard-Issues-White
bourse.videoposte.com	UT1-Finance
at5news.vinsontv.com	Chris-Whitelist
identity.virginmedia.com	Adguard-Sensitive-White
virginmoney.com	Adguard-Banks-White
vkmag.com	Chris-Whitelist
wargny.com	UT1-Finance
beta.wavesplatform.com	Adguard-Banks-White
wayforpay.com	Adguard-Banks-White
waze.com	Chris-Whitelist
wealthbar.com	Adguard-Banks-White
wealthfront.com	Adguard-Banks-White
wealthsimple.com	Adguard-Banks-White
web-revenue.com	UT1-Finance
webbankir.com	Adguard-Banks-White
webbet55a.com	UT1-Finance
trade.webborsam.com	Adguard-Banks-White
schneider-electric.webex.com	Chris-Whitelist
wellsfargo.com	Chris-Whitelist, Adguard-Banks-White
wellsfargoadvisors.com	Chris-Whitelist
wellsfargomedia.com	Chris-Whitelist
wescomfinancial.com	UT1-Finance
wesleyfinancialgroup.com	UT1-Finance
westlakefinancial.com	UT1-Finance
wetransfer.com	Chris-Whitelist
wework.com	Chris-Whitelist
whatsapp.com	Chris-Whitelist
windowsupdate.com	Chris-Whitelist
wingsfinancial.com	UT1-Finance
wire.com	Adguard-Android-White
checkout.wirecard.com	Adguard-Banks-White
wise.com	Adguard-Banks-White
wisechoicefinancial.com	UT1-Finance
wlp-acs.com	Adguard-Banks-White
wmtransfer.com	Adguard-Banks-White
wodtogether.com	Adguard-Android-White
online.woodforest.com	Adguard-Banks-White
woopic.com	Chris-Whitelist
wooppay.com	Adguard-Banks-White
wooribank.com	Adguard-Banks-White
worldfinancialcenter.com	UT1-Finance
worldfinancialgroup.com	UT1-Finance
worldfinancialreview.com	UT1-Finance
wp.com	AnuDeep
wunderlist.com	Adguard-Android-White
wyzecam.com	Chris-Whitelist
x-diesel.com	Chris-Whitelist
attestation.xboxlive.com	AnuDeep
device.auth.xboxlive.com	AnuDeep
title.auth.xboxlive.com	AnuDeep
xsts.auth.xboxlive.com	AnuDeep
def-vef.xboxlive.com	AnuDeep
eds.xboxlive.com	AnuDeep
xboxexperiencesprod.experimentation.xboxlive.com	AnuDeep
licensing.xboxlive.com	AnuDeep
cert.mgt.xboxlive.com	AnuDeep
title.mgt.xboxlive.com	AnuDeep
notify.xboxlive.com	AnuDeep
help.ui.xboxlive.com	AnuDeep
xflight.xboxlive.com	AnuDeep
xkms.xboxlive.com	AnuDeep
xda-cdn.com	Chris-Whitelist
xda-developers.com	Chris-Whitelist
xero.com	Adguard-Sensitive-White
imgs.xkcd.com	AnuDeep
secure.yakindogubank.com	Adguard-Banks-White
id.yandex.com	Adguard-Sensitive-White
passport.yandex.com	Adguard-Sensitive-White
yesrewardz.com	Adguard-Banks-White
youneedabudget.com	Adguard-Banks-White
s.youtube.com	Chris-Whitelist, AnuDeep
s2.youtube.com	AnuDeep
youtube-nocookie.com	Chris-Whitelist, AnuDeep
i.ytimg.com	AnuDeep
i1.ytimg.com	AnuDeep
s.ytimg.com	AnuDeep
zaim.com	Adguard-Banks-White
albelli.zendesk.com	Chris-Whitelist
zenstudios.com	Adguard-Android-White
zonebourse.com	UT1-Finance
zoom.com	Chris-Whitelist
fi.cr	Adguard-Banks-White
ebanking.eurobank.com.cy	Adguard-Banks-White
ib.airbank.cz	Adguard-Banks-White
csas.cz	Adguard-Banks-White
fio.cz	Adguard-Banks-White
internetbanka.cz	Adguard-Banks-White
online.mbank.cz	Adguard-Banks-White
mojebanka.cz	Adguard-Banks-White
mojezdravefinance.cz	Adguard-Banks-White
rb.cz	Adguard-Banks-White
sberbankcz.cz	Adguard-Banks-White
servis24.cz	Adguard-Banks-White
turris.cz	Chris-Whitelist
1822direkt.de	Adguard-Banks-White
1822direkt-banking.de	Adguard-Banks-White
aab.de	Adguard-Banks-White
abcbank.de	Adguard-Banks-White
abtsgmuender-bank.de	Adguard-Banks-White
akbank.de	Adguard-Banks-White
akf.de	Adguard-Banks-White
akf24.de	Adguard-Banks-White
allgaeuer-volksbank.de	Adguard-Banks-White
alxinger-bank.de	Adguard-Banks-White
apobank.de	Adguard-Banks-White
audibank.de	Adguard-Banks-White
augusta-bank.de	Adguard-Banks-White
banking.axa.de	Adguard-Banks-White
baaderbank.de	Adguard-Banks-White
bank11.de	Adguard-Banks-White
bank11direkt.de	Adguard-Banks-White
bank1saar.de	Adguard-Banks-White
bankhaus-hallbaum.de	Adguard-Banks-White
bankhaus-mayer.de	Adguard-Banks-White
bankhaus-plump.de	Adguard-Banks-White
banking-gefa-bank.de	Adguard-Banks-White
banking-merkur-bank.de	Adguard-Banks-White
banking-suedwestbank.de	Adguard-Banks-White
banking-wuestenrotdirect.de	Adguard-Banks-White
banklenz.de	Adguard-Banks-White
bankofscotland.de	Adguard-Banks-White
barclaycard.de	Adguard-Banks-White
barclays.de	Adguard-Banks-White
bbbank.de	Adguard-Banks-White
bensbergerbank.de	Adguard-Banks-White
berenberg.de	Adguard-Banks-White
bergische-volksbank.de	Adguard-Banks-White
berkheimer-bank.de	Adguard-Banks-White
berliner-sparkasse.de	Adguard-Banks-White
berliner-volksbank.de	Adguard-Banks-White
bernhauser-bank.de	Adguard-Banks-White
bethmannbank.de	Adguard-Banks-White
bhw.de	Adguard-Banks-White
bibessen.de	Adguard-Banks-White
biw-bank.de	Adguard-Banks-White
bkc-paderborn.de	Adguard-Banks-White
blocklist.de	Chris-Whitelist
blsk.de	Adguard-Banks-White
bmwbank.de	Adguard-Banks-White
bodenseebank.de	Adguard-Banks-White
bopfinger-bank.de	Adguard-Banks-White
bordesholmer-sparkasse.de	Adguard-Banks-White
bremischevb.de	Adguard-Banks-White
bruehlerbank.de	Adguard-Banks-White
bv-activebanking.de	Adguard-Banks-White
castell-bank.de	Adguard-Banks-White
cb-bank.de	Adguard-Banks-White
comdirect.de	Adguard-Banks-White
commerzbank.de	Adguard-Banks-White
consorsbank.de	Adguard-Banks-White
olb.consorsfinanz.de	Adguard-Banks-White
crediteurope.de	Adguard-Banks-White
creditplus.de	Adguard-Banks-White
cronbank.de	Adguard-Banks-White
cvw-privatbank-ag.de	Adguard-Banks-White
dab-bank.de	Adguard-Banks-White
datev.de	Adguard-Banks-White
degussa-bank.de	Adguard-Banks-White
deine-volksbank.de	Adguard-Banks-White
dettinger-bank.de	Adguard-Banks-White
deutsche-bank.de	Adguard-Banks-White
deutsche-factoring.de	Adguard-Banks-White
dhbbank.de	Adguard-Banks-White
die-raiffeisenbank.de	Adguard-Banks-White
die-vrbank.de	Adguard-Banks-White
diebank.de	Adguard-Banks-White
dkb.de	Adguard-Banks-White
dkm.de	Adguard-Banks-White
donau-iller-bank.de	Adguard-Banks-White
donner-reuschel.de	Adguard-Banks-White
dovoba.de	Adguard-Banks-White
dslbank.de	Adguard-Banks-White
dvrb.de	Adguard-Banks-White
dwpbank.de	Adguard-Banks-White
dzb-bank.de	Adguard-Banks-White
easycredit.de	Adguard-Banks-White
eb.de	Adguard-Banks-White
ebanking-hoernerbank.de	Adguard-Banks-White
echterdinger-bank.de	Adguard-Banks-White
eckernfoerder-bank.de	Adguard-Banks-White
edekabank.de	Adguard-Banks-White
elster.de	Adguard-Banks-White
emsland-mitte.de	Adguard-Banks-White
erfurter-bank.de	Adguard-Banks-White
erzgebirgssparkasse.de	Adguard-Banks-White
ethikbank-onlinebanking.de	Adguard-Banks-White
eurocitybank-onlinebanking.de	Adguard-Banks-White
evb-meppen.de	Adguard-Banks-White
evenordbank.de	Adguard-Banks-White
federseebank.de	Adguard-Banks-White
ffb.de	Adguard-Banks-White
fidor.de	Adguard-Banks-White
financial.de	UT1-Finance
flessabank.de	Adguard-Banks-White
foehr-amrumer-bank.de	Adguard-Banks-White
foerde-sparkasse.de	Adguard-Banks-White
fondsdepotbank.de	Adguard-Banks-White
frankenberger-bank.de	Adguard-Banks-White
frankfurter-sparkasse.de	Adguard-Banks-White
frankfurter-volksbank.de	Adguard-Banks-White
fs-bank.de	Adguard-Banks-White
fuggerbank-infoportal.de	Adguard-Banks-White
gabler-saliter-bank.de	Adguard-Banks-White
garantibank.de	Adguard-Banks-White
gefa-bank.de	Adguard-Banks-White
genoba-mecka.de	Adguard-Banks-White
genoba-weil.de	Adguard-Banks-White
genobamuc.de	Adguard-Banks-White
genobank.de	Adguard-Banks-White
genobank-mainz.de	Adguard-Banks-White
genobank-unterallgaeu.de	Adguard-Banks-White
gls.de	Adguard-Banks-White
gls-online-filiale.de	Adguard-Banks-White
gobank-online.de	Adguard-Banks-White
grafschafter-volksbank.de	Adguard-Banks-White
hafnerbank.de	Adguard-Banks-White
hagnauer-volksbank.de	Adguard-Banks-White
hallertauer-volksbank.de	Adguard-Banks-White
hamburger-volksbank.de	Adguard-Banks-White
hannoversche-volksbank.de	Adguard-Banks-White
hanseaticbank.de	Adguard-Banks-White
harzer-volksbank.de	Adguard-Banks-White
harzsparkasse.de	Adguard-Banks-White
haspa.de	Adguard-Banks-White
hauck-aufhaeuser.de	Adguard-Banks-White
hausbank.de	Adguard-Banks-White
hdh-voba.de	Adguard-Banks-White
heidelberger-volksbank.de	Adguard-Banks-White
helaba.de	Adguard-Banks-White
hermsdorfer-kreuz.de	Adguard-Banks-White
herner-sparkasse.de	Adguard-Banks-White
hkb.de	Adguard-Banks-White
huemmlinger-volksbank.de	Adguard-Banks-White
husumer-volksbank.de	Adguard-Banks-White
hypovereinsbank.de	Adguard-Banks-White
eantrag.ibb.de	Adguard-Banks-White
ihrziel.de	Adguard-Banks-White
ikb.de	Adguard-Banks-White
ing.de	Adguard-Banks-White
ing-diba.de	Adguard-Banks-White
jsafrasarasin.de	Adguard-Banks-White
kaltenkirchener-bank.de	Adguard-Banks-White
kasseler-sparkasse.de	Adguard-Banks-White
kd-bank.de	Adguard-Banks-White
kieler-volksbank.de	Adguard-Banks-White
kreissparkasse-ahrweiler.de	Adguard-Banks-White
kreissparkasse-augsburg.de	Adguard-Banks-White
kreissparkasse-diepholz.de	Adguard-Banks-White
kreissparkasse-duesseldorf.de	Adguard-Banks-White
kreissparkasse-eichsfeld.de	Adguard-Banks-White
kreissparkasse-euskirchen.de	Adguard-Banks-White
kreissparkasse-gotha.de	Adguard-Banks-White
kreissparkasse-heinsberg.de	Adguard-Banks-White
kreissparkasse-hoechstadt.de	Adguard-Banks-White
kreissparkasse-kelheim.de	Adguard-Banks-White
kreissparkasse-nordhausen.de	Adguard-Banks-White
kreissparkasse-osterholz.de	Adguard-Banks-White
kreissparkasse-ravensburg.de	Adguard-Banks-White
kreissparkasse-schwalm-eder.de	Adguard-Banks-White
ksk-anhalt-bitterfeld.de	Adguard-Banks-White
ksk-bautzen.de	Adguard-Banks-White
ksk-bc.de	Adguard-Banks-White
ksk-bersenbrueck.de	Adguard-Banks-White
ksk-birkenfeld.de	Adguard-Banks-White
ksk-boerde.de	Adguard-Banks-White
ksk-es.de	Adguard-Banks-White
ksk-fds.de	Adguard-Banks-White
ksk-gelnhausen.de	Adguard-Banks-White
ksk-gp.de	Adguard-Banks-White
ksk-heidenheim.de	Adguard-Banks-White
ksk-koeln.de	Adguard-Banks-White
ksk-kusel.de	Adguard-Banks-White
ksk-limburg.de	Adguard-Banks-White
ksk-mbteg.de	Adguard-Banks-White
ksk-melle.de	Adguard-Banks-White
ksk-ostalb.de	Adguard-Banks-White
ksk-ratzeburg.de	Adguard-Banks-White
ksk-reutlingen.de	Adguard-Banks-White
ksk-saale-orla.de	Adguard-Banks-White
ksk-saarlouis.de	Adguard-Banks-White
ksk-saarpfalz.de	Adguard-Banks-White
ksk-schluechtern.de	Adguard-Banks-White
ksk-sigmaringen.de	Adguard-Banks-White
ksk-soltau.de	Adguard-Banks-White
banking.ksk-stade.de	Adguard-Banks-White
ksk-steinfurt.de	Adguard-Banks-White
ksk-stendal.de	Adguard-Banks-White
ksk-syke.de	Adguard-Banks-White
ksk-tuebingen.de	Adguard-Banks-White
ksk-tut.de	Adguard-Banks-White
ksk-verden.de	Adguard-Banks-White
ksk-vulkaneifel.de	Adguard-Banks-White
ksk-walsrode.de	Adguard-Banks-White
ksk-weilburg.de	Adguard-Banks-White
kskbb.de	Adguard-Banks-White
kskbitburg-pruem.de	Adguard-Banks-White
kskgrossgerau.de	Adguard-Banks-White
kskhalle.de	Adguard-Banks-White
kskkl.de	Adguard-Banks-White
ksklb.de	Adguard-Banks-White
kskmayen.de	Adguard-Banks-White
kskmse.de	Adguard-Banks-White
kskrh.de	Adguard-Banks-White
kskwd.de	Adguard-Banks-White
kskwn.de	Adguard-Banks-White
kskwnd.de	Adguard-Banks-White
ksn-northeim.de	Adguard-Banks-White
kt-bank.de	Adguard-Banks-White
kunden-mkb-bank.de	Adguard-Banks-White
kyffhaeusersparkasse.de	Adguard-Banks-White
landbank-horlofftal.de	Adguard-Banks-White
kreditkarten-banking.lbb.de	Adguard-Banks-White
leaseplanbank.de	Adguard-Banks-White
leipziger-volksbank.de	Adguard-Banks-White
levo-bank.de	Adguard-Banks-White
lexoffice.de	Adguard-Banks-White
ligabank.de	Adguard-Banks-White
loebbecke-bank.de	Adguard-Banks-White
love-money.de	UT1-Finance
maerkische-bank.de	Adguard-Banks-White
marcard.de	Adguard-Banks-White
martinbank.de	Adguard-Banks-White
mbs.de	Adguard-Banks-White
meine-bank-no.de	Adguard-Banks-White
meine-hausbank.de	Adguard-Banks-White
meine-vrbank.de	Adguard-Banks-White
meine-vvb.de	Adguard-Banks-White
meinebank.de	Adguard-Banks-White
meinevolksbank.de	Adguard-Banks-White
mercedes-benz-bank.de	Adguard-Banks-White
merckfinck.de	Adguard-Banks-White
mlb.de	Adguard-Banks-White
mlp.de	Adguard-Banks-White
moneyou.de	Adguard-Banks-White
muenchner-bank.de	Adguard-Banks-White
mueritz-sparkasse.de	Adguard-Banks-White
mvb.de	Adguard-Banks-White
my-volksbank.de	Adguard-Banks-White
naspa.de	Adguard-Banks-White
netbank.de	Adguard-Banks-White
netdebit-payment.de	UT1-Finance
nispa.de	Adguard-Banks-White
nobaeg.de	Adguard-Banks-White
nordthueringer-volksbank.de	Adguard-Banks-White
norisbank.de	Adguard-Banks-White
nospa.de	Adguard-Banks-White
nuernberg.de	Adguard-Issues-White
oberlandbank.de	Adguard-Banks-White
olb.de	Adguard-Banks-White
onlinebanking-aktivbank.de	Adguard-Banks-White
onlinebanking-alxinger-bank.de	Adguard-Banks-White
onlinebanking-bankhausbauer.de	Adguard-Banks-White
onlinebanking-ellwanger-geiger.de	Adguard-Banks-White
onlinebanking-equinetbank.de	Adguard-Banks-White
onlinebanking-frankfurter-bankgesellschaft.de	Adguard-Banks-White
onlinebanking-fuggerbank.de	Adguard-Banks-White
onlinebanking-grenkebank.de	Adguard-Banks-White
onlinebanking-httenberger-bank.de	Adguard-Banks-White
onlinebanking-meine-bank.de	Adguard-Banks-White
onlinebanking-northchannelbank.de	Adguard-Banks-White
onlinebanking-psd-berlin-brandenburg.de	Adguard-Banks-White
onlinebanking-psd-braunschweig.de	Adguard-Banks-White
onlinebanking-psd-hannover.de	Adguard-Banks-White
onlinebanking-psd-karlsruhe-neustadt.de	Adguard-Banks-White
onlinebanking-psd-kiel.de	Adguard-Banks-White
onlinebanking-psd-koblenz.de	Adguard-Banks-White
onlinebanking-psd-koeln.de	Adguard-Banks-White
onlinebanking-psd-muenchen.de	Adguard-Banks-White
onlinebanking-psd-nord.de	Adguard-Banks-White
onlinebanking-psd-nuernberg.de	Adguard-Banks-White
onlinebanking-psd-rhein-ruhr.de	Adguard-Banks-White
onlinebanking-psd-rheinneckarsaar.de	Adguard-Banks-White
onlinebanking-psd-westfalen-lippe.de	Adguard-Banks-White
onlinebanking-psdbank-ht.de	Adguard-Banks-White
onlinebanking-raiba-msp.de	Adguard-Banks-White
onlinebanking-raiba-pfaffenhofen.de	Adguard-Banks-White
onlinebanking-raiba-tuengental.de	Adguard-Banks-White
onlinebanking-raiffeisenbank-heroldsbach.de	Adguard-Banks-White
onlinebanking-raiffeisenbank-hiltenfingen.de	Adguard-Banks-White
onlinebanking-raiffeisenbank-regenstauf.de	Adguard-Banks-White
onlinebanking-rautenschleinbank.de	Adguard-Banks-White
onlinebanking-rb-beuerberg.de	Adguard-Banks-White
onlinebanking-rb-hersbruck.de	Adguard-Banks-White
onlinebanking-rb-plankstetten.de	Adguard-Banks-White
onlinebanking-rsb-bank.de	Adguard-Banks-White
onlinebanking-rv-banken.de	Adguard-Banks-White
onlinebanking-rv-direkt.de	Adguard-Banks-White
onlinebanking-sarasin.de	Adguard-Banks-White
onlinebanking-schroederbank.de	Adguard-Banks-White
onlinebanking-volksbank-hochrhein.de	Adguard-Banks-White
onlinebanking-vr-bank-nuernberg.de	Adguard-Banks-White
onlinebanking-vrbanknet.de	Adguard-Banks-White
onstmettinger-bank.de	Adguard-Banks-White
webtrading.onvista-bank.de	Adguard-Banks-White
opelbank.de	Adguard-Banks-White
ospa.de	Adguard-Banks-White
ostfriesische-volksbank.de	Adguard-Banks-White
ostsaechsische-sparkasse-dresden.de	Adguard-Banks-White
oyakankerbank.de	Adguard-Banks-White
pax-bank.de	Adguard-Banks-White
paydirekt.de	Adguard-Banks-White
picnic.de	Chris-Whitelist
pommerschevb.de	Adguard-Banks-White
banking.postbank.de	Adguard-Banks-White
meine.postbank.de	Adguard-Banks-White
posteo.de	Adguard-Sensitive-White
procreditbank.de	Adguard-Banks-White
psd-berlin-brandenburg.de	Adguard-Banks-White
psd-braunschweig.de	Adguard-Banks-White
psd-hannover.de	Adguard-Banks-White
psd-karlsruhe-neustadt.de	Adguard-Banks-White
psd-kiel.de	Adguard-Banks-White
psd-koblenz.de	Adguard-Banks-White
psd-koeln.de	Adguard-Banks-White
psd-muenchen.de	Adguard-Banks-White
psd-nord.de	Adguard-Banks-White
psd-nuernberg.de	Adguard-Banks-White
psd-rhein-ruhr.de	Adguard-Banks-White
psd-rheinneckarsaar.de	Adguard-Banks-White
psd-westfalen-lippe.de	Adguard-Banks-White
psdbank-ht.de	Adguard-Banks-White
quirinprivatbank.de	Adguard-Banks-White
quirion.de	Adguard-Banks-White
r-volksbank.de	Adguard-Banks-White
rabodirect.de	Adguard-Banks-White
raiba-aiglsbach.de	Adguard-Banks-White
raiba-aindling.de	Adguard-Banks-White
raiba-aitrang-rud.de	Adguard-Banks-White
raiba-alsbach.de	Adguard-Banks-White
raiba-altdorf-feucht.de	Adguard-Banks-White
raiba-altschweier.de	Adguard-Banks-White
raiba-aschaffenburg.de	Adguard-Banks-White
raiba-bad-schussenried.de	Adguard-Banks-White
raiba-beilngries.de	Adguard-Banks-White
raiba-bibertgrund.de	Adguard-Banks-White
raiba-bidingen.de	Adguard-Banks-White
raiba-bobingen.de	Adguard-Banks-White
raiba-boellingertal.de	Adguard-Banks-White
raiba-buehlertal.de	Adguard-Banks-White
raiba-buett-gauk.de	Adguard-Banks-White
raiba-burgthann.de	Adguard-Banks-White
raiba-bw.de	Adguard-Banks-White
raiba-donau-heuberg.de	Adguard-Banks-White
raiba-elsavatal.de	Adguard-Banks-White
raiba-erlenmoos.de	Adguard-Banks-White
raiba-fkh.de	Adguard-Banks-White
raiba-flachsmeer.de	Adguard-Banks-White
raiba-floss.de	Adguard-Banks-White
raiba-gaimbux.de	Adguard-Banks-White
raiba-gh.de	Adguard-Banks-White
raiba-gilching.de	Adguard-Banks-White
raiba-gotha.de	Adguard-Banks-White
raiba-gr.de	Adguard-Banks-White
raiba-gretha.de	Adguard-Banks-White
raiba-grimma.de	Adguard-Banks-White
raiba-hoechberg.de	Adguard-Banks-White
raiba-idafehn.de	Adguard-Banks-White
raiba-kaarst.de	Adguard-Banks-White
raiba-ke-oa.de	Adguard-Banks-White
raiba-kehrig.de	Adguard-Banks-White
raiba-kms.de	Adguard-Banks-White
raiba-kraichgau.de	Adguard-Banks-White
raiba-mittenwald.de	Adguard-Banks-White
raiba-moetzingen.de	Adguard-Banks-White
raiba-moselkrampen.de	Adguard-Banks-White
raiba-msp.de	Adguard-Banks-White
raiba-muc-sued.de	Adguard-Banks-White
raiba-mutlangen.de	Adguard-Banks-White
raiba-ndwa.de	Adguard-Banks-White
raiba-neumarkt-opf.de	Adguard-Banks-White
raiba-neustadt.de	Adguard-Banks-White
raiba-nuedlingen.de	Adguard-Banks-White
raiba-oldenburg.de	Adguard-Banks-White
raiba-parsberg-velburg.de	Adguard-Banks-White
raiba-pfaffenhofen.de	Adguard-Banks-White
raiba-pfaffenwinkel.de	Adguard-Banks-White
raiba-rastede.de	Adguard-Banks-White
raiba-rehling.de	Adguard-Banks-White
raiba-ried.de	Adguard-Banks-White
raiba-riedenburg.de	Adguard-Banks-White
raiba-rosbach.de	Adguard-Banks-White
raiba-roth-schwabach.de	Adguard-Banks-White
raiba-rupertiwinkel.de	Adguard-Banks-White
raiba-schwabmuenchen.de	Adguard-Banks-White
raiba-seenplatte.de	Adguard-Banks-White
raiba-steingaden.de	Adguard-Banks-White
raiba-steinheim.de	Adguard-Banks-White
raiba-suedhardt.de	Adguard-Banks-White
raiba-ueda.de	Adguard-Banks-White
raiba-wallgau-kruen.de	Adguard-Banks-White
raiba-welling.de	Adguard-Banks-White
raiba-westhausen.de	Adguard-Banks-White
raibacalw.de	Adguard-Banks-White
raibadirekt.de	Adguard-Banks-White
raibahallertau.de	Adguard-Banks-White
raibahandewitt.de	Adguard-Banks-White
raibalauenburg.de	Adguard-Banks-White
raibamol.de	Adguard-Banks-White
raibank.de	Adguard-Banks-White
raibawesermarschsued.de	Adguard-Banks-White
raibawiesedermeer.de	Adguard-Banks-White
raiffeisen-privatbank.de	Adguard-Banks-White
raiffeisen-privatbank-landing.de	Adguard-Banks-White
raiffeisen-volksbank-neustadt.de	Adguard-Banks-White
raiffeisenbank-bargteheide.de	Adguard-Banks-White
raiffeisenbank-bauschlott.de	Adguard-Banks-White
raiffeisenbank-bs.de	Adguard-Banks-White
raiffeisenbank-eichenbuehl.de	Adguard-Banks-White
raiffeisenbank-elztal.de	Adguard-Banks-White
raiffeisenbank-erlenbach.de	Adguard-Banks-White
raiffeisenbank-gmund.de	Adguard-Banks-White
raiffeisenbank-gruibingen.de	Adguard-Banks-White
raiffeisenbank-gundelfingen.de	Adguard-Banks-White
raiffeisenbank-heroldsbach.de	Adguard-Banks-White
raiffeisenbank-hiltenfingen.de	Adguard-Banks-White
raiffeisenbank-irrel.de	Adguard-Banks-White
raiffeisenbank-kaiserstuhl.de	Adguard-Banks-White
raiffeisenbank-kastellaun.de	Adguard-Banks-White
raiffeisenbank-lorup.de	Adguard-Banks-White
raiffeisenbank-maitis.de	Adguard-Banks-White
raiffeisenbank-mengkofen-loiching.de	Adguard-Banks-White
raiffeisenbank-neudenau.de	Adguard-Banks-White
raiffeisenbank-oberteuringen.de	Adguard-Banks-White
raiffeisenbank-ottenbach.de	Adguard-Banks-White
raiffeisenbank-plankstetten.de	Adguard-Banks-White
raiffeisenbank-regensburg.de	Adguard-Banks-White
raiffeisenbank-rosenstein.de	Adguard-Banks-White
raiffeisenbank-simmerath.de	Adguard-Banks-White
raiffeisenbank-sinzing.de	Adguard-Banks-White
raiffeisenbank-straubing.de	Adguard-Banks-White
raiffeisenbank-unterwesterwald.de	Adguard-Banks-White
raiffeisenbank-urbach.de	Adguard-Banks-White
raiffeisenbank-vordere-alb.de	Adguard-Banks-White
raiffeisenbank-vordersteinenberg.de	Adguard-Banks-White
raiffeisenbank-wangen.de	Adguard-Banks-White
raiffeisenbank-weissach.de	Adguard-Banks-White
raiffeisenbank-westallgaeu.de	Adguard-Banks-White
raiffeisenbank-wyhl.de	Adguard-Banks-White
raiffeisenbankersingen.de	Adguard-Banks-White
raika-erbes-buedesheim.de	Adguard-Banks-White
rb-adel-siel.de	Adguard-Banks-White
rb-af.de	Adguard-Banks-White
rb-ags.de	Adguard-Banks-White
rb-ah.de	Adguard-Banks-White
rb-allgaeuerland.de	Adguard-Banks-White
rb-altdorf-ergolding.de	Adguard-Banks-White
rb-am-kulm.de	Adguard-Banks-White
rb-am-rothsee.de	Adguard-Banks-White
rb-anger.de	Adguard-Banks-White
rb-arge.de	Adguard-Banks-White
rb-arnstorf.de	Adguard-Banks-White
rb-as.de	Adguard-Banks-White
rb-asbach.de	Adguard-Banks-White
rb-aschberg.de	Adguard-Banks-White
rb-augsburgerland.de	Adguard-Banks-White
rb-bad-abbach-saal.de	Adguard-Banks-White
rb-bad-goegging.de	Adguard-Banks-White
rb-bad-saulgau.de	Adguard-Banks-White
rb-baunatal.de	Adguard-Banks-White
rb-bechhofen.de	Adguard-Banks-White
rb-berghuelen.de	Adguard-Banks-White
rb-beuerberg.de	Adguard-Banks-White
rb-bfm.de	Adguard-Banks-White
rb-biberach.de	Adguard-Banks-White
rb-biebergrund-petersberg.de	Adguard-Banks-White
rb-bruck-opf.de	Adguard-Banks-White
rb-burghaun.de	Adguard-Banks-White
rb-burgstaedt.de	Adguard-Banks-White
rb-chamer-land.de	Adguard-Banks-White
rb-chiemgau-nord.de	Adguard-Banks-White
rb-deggendorf.de	Adguard-Banks-White
rb-denzlingen-sexau.de	Adguard-Banks-White
rb-dietersheim.de	Adguard-Banks-White
rb-donaumooser-land.de	Adguard-Banks-White
rb-dreisessel.de	Adguard-Banks-White
rb-eb.de	Adguard-Banks-White
rb-ebrachgrund.de	Adguard-Banks-White
rb-ebsdorfergrund.de	Adguard-Banks-White
rb-eching.de	Adguard-Banks-White
rb-eggenthal.de	Adguard-Banks-White
rb-ehekirchen.de	Adguard-Banks-White
rb-ehingen-hochstraess.de	Adguard-Banks-White
rb-eifeltor.de	Adguard-Banks-White
rb-elln.de	Adguard-Banks-White
rb-emtmannsberg.de	Adguard-Banks-White
rb-erkelenz.de	Adguard-Banks-White
rb-eschweiler.de	Adguard-Banks-White
rb-essenbach.de	Adguard-Banks-White
rb-flieden.de	Adguard-Banks-White
rb-fraenkisches-weinland.de	Adguard-Banks-White
rb-frankenhardt-stimpfach.de	Adguard-Banks-White
rb-frankenwinheim.de	Adguard-Banks-White
rb-frechen-huerth.de	Adguard-Banks-White
rb-freinsheim.de	Adguard-Banks-White
rb-fuchstal.de	Adguard-Banks-White
rb-gefrees.de	Adguard-Banks-White
rb-geiselhoering.de	Adguard-Banks-White
rb-grabfeld.de	Adguard-Banks-White
rb-graevenwiesbach.de	Adguard-Banks-White
rb-grainet.de	Adguard-Banks-White
rb-grossenlueder.de	Adguard-Banks-White
rb-grosskarolinenfeld.de	Adguard-Banks-White
rb-gymnich.de	Adguard-Banks-White
rb-hab.de	Adguard-Banks-White
rb-hardt-bruhrain.de	Adguard-Banks-White
rb-hei.de	Adguard-Banks-White
rb-heiligenstadt.de	Adguard-Banks-White
rb-hersbruck.de	Adguard-Banks-White
rb-hessennord.de	Adguard-Banks-White
rb-hfw.de	Adguard-Banks-White
rb-hirschau.de	Adguard-Banks-White
rb-hk.de	Adguard-Banks-White
rb-hofkirchen-bayerbach.de	Adguard-Banks-White
rb-holzheim.de	Adguard-Banks-White
rb-holzkirchen-otterfing.de	Adguard-Banks-White
rb-horb.de	Adguard-Banks-White
rb-hs.de	Adguard-Banks-White
rb-ichenhausen.de	Adguard-Banks-White
rb-im-naabtal.de	Adguard-Banks-White
rb-jettingen.de	Adguard-Banks-White
rb-kieselbronn.de	Adguard-Banks-White
rb-kirchweihtal.de	Adguard-Banks-White
rb-kirtorf.de	Adguard-Banks-White
rb-kitzingerland.de	Adguard-Banks-White
rb-km.de	Adguard-Banks-White
rb-knoblauchsland.de	Adguard-Banks-White
rb-koetzting.de	Adguard-Banks-White
rb-lauf.de	Adguard-Banks-White
rb-massbach.de	Adguard-Banks-White
rb-mehrstetten.de	Adguard-Banks-White
rb-mittelschwaben.de	Adguard-Banks-White
rb-muenchen-nord.de	Adguard-Banks-White
rb-nahe.de	Adguard-Banks-White
rb-new-voh.de	Adguard-Banks-White
rb-niedere-alb.de	Adguard-Banks-White
rb-nordkreis.de	Adguard-Banks-White
rb-nr.de	Adguard-Banks-White
rb-oberaudorf.de	Adguard-Banks-White
rb-oberes-gaeu.de	Adguard-Banks-White
rb-onw.de	Adguard-Banks-White
rb-os.de	Adguard-Banks-White
rb-parkstetten.de	Adguard-Banks-White
rb-pfaffenhausen.de	Adguard-Banks-White
rb-pfeffenhausen.de	Adguard-Banks-White
rb-raisting.de	Adguard-Banks-White
rb-rattiszell-konzell.de	Adguard-Banks-White
rb-reute-gaisbeuren.de	Adguard-Banks-White
rb-schaafheim.de	Adguard-Banks-White
rb-schwaben.de	Adguard-Banks-White
rb-schwandorf-nittenau.de	Adguard-Banks-White
rb-singoldtal.de	Adguard-Banks-White
rb-sobland.de	Adguard-Banks-White
rb-sondelfingen.de	Adguard-Banks-White
rb-stauden.de	Adguard-Banks-White
rb-stw.de	Adguard-Banks-White
rb-sued-oal.de	Adguard-Banks-White
rb-thannhausen.de	Adguard-Banks-White
rb-thurnauerland.de	Adguard-Banks-White
rb-tofk.de	Adguard-Banks-White
rb-tuerkheim.de	Adguard-Banks-White
rb-uz.de	Adguard-Banks-White
rb-volkach-wiesentheid.de	Adguard-Banks-White
rb-volkmarsen.de	Adguard-Banks-White
rb-voreifel.de	Adguard-Banks-White
rb-waischenfeld.de	Adguard-Banks-White
rb-wald.de	Adguard-Banks-White
rb-waldaschaff.de	Adguard-Banks-White
rb-wegscheid.de	Adguard-Banks-White
rb-westeifel.de	Adguard-Banks-White
rb-wimsheim-moensheim.de	Adguard-Banks-White
rb-windsbach.de	Adguard-Banks-White
rb-wittislingen.de	Adguard-Banks-White
rb-wl.de	Adguard-Banks-White
rb-wuestenselbitz.de	Adguard-Banks-White
rb-wug.de	Adguard-Banks-White
rb-zellerland.de	Adguard-Banks-White
rb-zorneding.de	Adguard-Banks-White
rbbissingen.de	Adguard-Banks-White
rbbn.de	Adguard-Banks-White
rbborken.de	Adguard-Banks-White
rbbutjadingenabbehausen.de	Adguard-Banks-White
rbelbmarsch.de	Adguard-Banks-White
rberding.de	Adguard-Banks-White
rbfalkenstein-woerth.de	Adguard-Banks-White
rbgarrel.de	Adguard-Banks-White
rbk-haag-gars.de	Adguard-Banks-White
rbk-rsa.de	Adguard-Banks-White
rbkalbe-bismark.de	Adguard-Banks-White
rbkj.de	Adguard-Banks-White
rbleezen.de	Adguard-Banks-White
rbmalchin.de	Adguard-Banks-White
rbmehring-leiwen.de	Adguard-Banks-White
rbobermain.de	Adguard-Banks-White
rbok.de	Adguard-Banks-White
rbopr.de	Adguard-Banks-White
rbowschlag.de	Adguard-Banks-White
rbpn.de	Adguard-Banks-White
rbratzeburg.de	Adguard-Banks-White
rbrodenbach.de	Adguard-Banks-White
rbsbw.de	Adguard-Banks-White
rbscharrel.de	Adguard-Banks-White
rbseestermuehe.de	Adguard-Banks-White
rbstruvenhuetten.de	Adguard-Banks-White
rbsum.de	Adguard-Banks-White
rbsuro.de	Adguard-Banks-White
rbtodenbuettel.de	Adguard-Banks-White
rbui.de	Adguard-Banks-White
rbuv.de	Adguard-Banks-White
renault-bank-direkt.de	Adguard-Banks-White
rheingauer-volksbank.de	Adguard-Banks-White
rhoen-rennsteig-sparkasse.de	Adguard-Banks-White
rileg.de	Adguard-Banks-White
banking.rostocker-vrbank.de	Adguard-Banks-White
rottaler-raiba.de	Adguard-Banks-White
rv-bank-lif.de	Adguard-Banks-White
rv-banken.de	Adguard-Banks-White
rv-direkt.de	Adguard-Banks-White
rv-ebe.de	Adguard-Banks-White
rvb-bad-staffelstein.de	Adguard-Banks-White
rvb-direkt.de	Adguard-Banks-White
rvb-donauwoerth.de	Adguard-Banks-White
rvb-hassberge.de	Adguard-Banks-White
rvb-saale-orla.de	Adguard-Banks-White
rvbank-rhein-haardt.de	Adguard-Banks-White
rvbankries.de	Adguard-Banks-White
rvbfresena.de	Adguard-Banks-White
rvbmil.de	Adguard-Banks-White
rvboderspree.de	Adguard-Banks-White
rvbvarelnordenham.de	Adguard-Banks-White
rvbwemding.de	Adguard-Banks-White
s-jena.de	Adguard-Banks-White
s-kukc.de	Adguard-Banks-White
s-mil.de	Adguard-Banks-White
s-os.de	Adguard-Banks-White
saalesparkasse.de	Adguard-Banks-White
salzlandsparkasse.de	Adguard-Banks-White
santander.de	Adguard-Banks-White
sbroker.de	Adguard-Banks-White
scharnhauserbank.de	Adguard-Banks-White
schwaebisch-hall.de	Adguard-Banks-White
schwaebische-bank.de	Adguard-Banks-White
sdk-bockum-hoevel.de	Adguard-Banks-White
sdk-stockhausen.de	Adguard-Banks-White
sdkinlamstedt.de	Adguard-Banks-White
factoring.seb.de	Adguard-Banks-White
secb.de	Adguard-Banks-White
secure-banking.de	Adguard-Banks-White
seebachgrund.de	Adguard-Banks-White
seeligerbank.de	Adguard-Banks-White
sevdesk.de	Adguard-Banks-White
sgkb.de	Adguard-Banks-White
shallalist.de	Chris-Whitelist
shinhan.de	Adguard-Banks-White
signal-iduna.de	Adguard-Sensitive-White
sk-westerwald-sieg.de	Adguard-Banks-White
skb-badhomburg.de	Adguard-Banks-White
skb-buehlertal.de	Adguard-Banks-White
skb-dauchingen.de	Adguard-Banks-White
skb-gemuenden.de	Adguard-Banks-White
skb-hammah.de	Adguard-Banks-White
skb-hardt.de	Adguard-Banks-White
skb-rheinstetten.de	Adguard-Banks-White
skbwitten.de	Adguard-Banks-White
skmb.de	Adguard-Banks-White
sl-vb.de	Adguard-Banks-White
sls-direkt.de	Adguard-Banks-White
sms-hm.de	Adguard-Banks-White
sob-bank.de	Adguard-Banks-White
sozialbank.de	Adguard-Banks-White
spadaka-friesoythe.de	Adguard-Banks-White
spadaka-hoengen.de	Adguard-Banks-White
spadaka-oeventrop.de	Adguard-Banks-White
spadaka-reken.de	Adguard-Banks-White
sparda.de	Adguard-Banks-White
sparda-a.de	Adguard-Banks-White
sparda-b.de	Adguard-Banks-White
sparda-bank-hamburg.de	Adguard-Banks-White
sparda-bw.de	Adguard-Banks-White
sparda-h.de	Adguard-Banks-White
sparda-hessen.de	Adguard-Banks-White
sparda-m.de	Adguard-Banks-White
sparda-ms.de	Adguard-Banks-White
sparda-n.de	Adguard-Banks-White
sparda-ostbayern.de	Adguard-Banks-White
sparda-sw.de	Adguard-Banks-White
sparda-west.de	Adguard-Banks-White
sparkasse-aachen.de	Adguard-Banks-White
sparkasse-adl.de	Adguard-Banks-White
sparkasse-alk.de	Adguard-Banks-White
sparkasse-allgaeu.de	Adguard-Banks-White
sparkasse-altenburgerland.de	Adguard-Banks-White
sparkasse-am-niederrhein.de	Adguard-Banks-White
sparkasse-amberg-sulzbach.de	Adguard-Banks-White
sparkasse-ansbach.de	Adguard-Banks-White
sparkasse-arnsberg-sundern.de	Adguard-Banks-White
sparkasse-aurich-norden.de	Adguard-Banks-White
sparkasse-badneustadt.de	Adguard-Banks-White
sparkasse-bamberg.de	Adguard-Banks-White
sparkasse-battenberg.de	Adguard-Banks-White
sparkasse-bayreuth.de	Adguard-Banks-White
sparkasse-beckum.de	Adguard-Banks-White
sparkasse-bensheim.de	Adguard-Banks-White
sparkasse-bgl.de	Adguard-Banks-White
sparkasse-bielefeld.de	Adguard-Banks-White
sparkasse-blomberg.de	Adguard-Banks-White
sparkasse-bochum.de	Adguard-Banks-White
sparkasse-bodensee.de	Adguard-Banks-White
sparkasse-bonndorf-stuehlingen.de	Adguard-Banks-White
sparkasse-bottrop.de	Adguard-Banks-White
finanzcenter.sparkasse-bremen.de	Adguard-Banks-White
sparkasse-burbach-neunkirchen.de	Adguard-Banks-White
sparkasse-celle.de	Adguard-Banks-White
sparkasse-co-lif.de	Adguard-Banks-White
sparkasse-dachau.de	Adguard-Banks-White
sparkasse-darmstadt.de	Adguard-Banks-White
sparkasse-delbrueck.de	Adguard-Banks-White
sparkasse-dessau.de	Adguard-Banks-White
sparkasse-dieburg.de	Adguard-Banks-White
sparkasse-dillenburg.de	Adguard-Banks-White
sparkasse-dillingen.de	Adguard-Banks-White
sparkasse-doebeln.de	Adguard-Banks-White
sparkasse-donauwoerth.de	Adguard-Banks-White
sparkasse-donnersberg.de	Adguard-Banks-White
sparkasse-dortmund.de	Adguard-Banks-White
sparkasse-duderstadt.de	Adguard-Banks-White
sparkasse-dueren.de	Adguard-Banks-White
sparkasse-duisburg.de	Adguard-Banks-White
sparkasse-einbeck.de	Adguard-Banks-White
sparkasse-elmshorn.de	Adguard-Banks-White
sparkasse-emden.de	Adguard-Banks-White
sparkasse-emh.de	Adguard-Banks-White
sparkasse-emsland.de	Adguard-Banks-White
sparkasse-engo.de	Adguard-Banks-White
sparkasse-ennepetal.de	Adguard-Banks-White
sparkasse-erlangen.de	Adguard-Banks-White
sparkasse-erwitte-anroechte.de	Adguard-Banks-White
sparkasse-essen.de	Adguard-Banks-White
sparkasse-ffb.de	Adguard-Banks-White
sparkasse-finnentrop.de	Adguard-Banks-White
sparkasse-forchheim.de	Adguard-Banks-White
sparkasse-freiburg.de	Adguard-Banks-White
sparkasse-freising.de	Adguard-Banks-White
sparkasse-fuerth.de	Adguard-Banks-White
sparkasse-fulda.de	Adguard-Banks-White
sparkasse-garmisch.de	Adguard-Banks-White
sparkasse-gelsenkirchen.de	Adguard-Banks-White
sparkasse-ger-kandel.de	Adguard-Banks-White
sparkasse-gera-greiz.de	Adguard-Banks-White
sparkasse-geseke.de	Adguard-Banks-White
sparkasse-gevelsberg.de	Adguard-Banks-White
sparkasse-giessen.de	Adguard-Banks-White
sparkasse-gladbeck.de	Adguard-Banks-White
sparkasse-gm.de	Adguard-Banks-White
sparkasse-goch.de	Adguard-Banks-White
sparkasse-gruenberg.de	Adguard-Banks-White
sparkasse-guenzburg-krumbach.de	Adguard-Banks-White
sparkasse-guetersloh.de	Adguard-Banks-White
sparkasse-gunzenhausen.de	Adguard-Banks-White
sparkasse-hagen.de	Adguard-Banks-White
sparkasse-hamm.de	Adguard-Banks-White
sparkasse-hanau.de	Adguard-Banks-White
sparkasse-hannover.de	Adguard-Banks-White
sparkasse-haslach-zell.de	Adguard-Banks-White
sparkasse-hattingen.de	Adguard-Banks-White
sparkasse-hegau-bodensee.de	Adguard-Banks-White
sparkasse-heidelberg.de	Adguard-Banks-White
sparkasse-heilbronn.de	Adguard-Banks-White
sparkasse-hellweg-lippe.de	Adguard-Banks-White
sparkasse-herford.de	Adguard-Banks-White
sparkasse-hildburghausen.de	Adguard-Banks-White
sparkasse-hildesheim.de	Adguard-Banks-White
sparkasse-hochfranken.de	Adguard-Banks-White
sparkasse-hochrhein.de	Adguard-Banks-White
sparkasse-hochsauerland.de	Adguard-Banks-White
sparkasse-hochschwarzwald.de	Adguard-Banks-White
sparkasse-hoexter.de	Adguard-Banks-White
sparkasse-holstein.de	Adguard-Banks-White
sparkasse-honnef.de	Adguard-Banks-White
sparkasse-hrv.de	Adguard-Banks-White
sparkasse-iserlohn.de	Adguard-Banks-White
sparkasse-jerichower-land.de	Adguard-Banks-White
sparkasse-karlsruhe.de	Adguard-Banks-White
sparkasse-kaufbeuren.de	Adguard-Banks-White
sparkasse-kehl.de	Adguard-Banks-White
sparkasse-kleve.de	Adguard-Banks-White
sparkasse-koblenz.de	Adguard-Banks-White
bankingportal.sparkasse-koelnbonn.de	Adguard-Banks-White
sparkasse-kraichgau.de	Adguard-Banks-White
sparkasse-krefeld.de	Adguard-Banks-White
sparkasse-landsberg.de	Adguard-Banks-White
sparkasse-landshut.de	Adguard-Banks-White
sparkasse-langenfeld.de	Adguard-Banks-White
sparkasse-leerwittmund.de	Adguard-Banks-White
sparkasse-leipzig.de	Adguard-Banks-White
sparkasse-lemgo.de	Adguard-Banks-White
sparkasse-lev.de	Adguard-Banks-White
sparkasse-lippstadt.de	Adguard-Banks-White
sparkasse-loerrach.de	Adguard-Banks-White
sparkasse-luedenscheid.de	Adguard-Banks-White
sparkasse-lueneburg.de	Adguard-Banks-White
sparkasse-magdeburg.de	Adguard-Banks-White
sparkasse-mainfranken.de	Adguard-Banks-White
sparkasse-mainz.de	Adguard-Banks-White
sparkasse-markgraeflerland.de	Adguard-Banks-White
sparkasse-mecklenburg-schwerin.de	Adguard-Banks-White
sparkasse-meissen.de	Adguard-Banks-White
sparkasse-meschede.de	Adguard-Banks-White
sparkasse-minden-luebbecke.de	Adguard-Banks-White
sparkasse-mittelfranken-sued.de	Adguard-Banks-White
banking.sparkasse-mittelsachsen.de	Adguard-Banks-White
sparkasse-mittelthueringen.de	Adguard-Banks-White
sparkasse-moenchengladbach.de	Adguard-Banks-White
sparkasse-mol.de	Adguard-Banks-White
sparkasse-moosburg.de	Adguard-Banks-White
sparkasse-msh.de	Adguard-Banks-White
sparkasse-muelheim-ruhr.de	Adguard-Banks-White
sparkasse-muensterland-ost.de	Adguard-Banks-White
sparkasse-nea.de	Adguard-Banks-White
sparkasse-neckartal-odenwald.de	Adguard-Banks-White
sparkasse-neu-ulm-illertissen.de	Adguard-Banks-White
sparkasse-neuburg-rain.de	Adguard-Banks-White
sparkasse-neumarkt.de	Adguard-Banks-White
sparkasse-neunkirchen.de	Adguard-Banks-White
sparkasse-neuss.de	Adguard-Banks-White
sparkasse-neuwied.de	Adguard-Banks-White
sparkasse-niederbayern-mitte.de	Adguard-Banks-White
sparkasse-niederlausitz.de	Adguard-Banks-White
banking.sparkasse-nienburg.de	Adguard-Banks-White
sparkasse-noerdlingen.de	Adguard-Banks-White
sparkasse-nordhorn.de	Adguard-Banks-White
sparkasse-nuernberg.de	Adguard-Banks-White
sparkasse-oberhessen.de	Adguard-Banks-White
sparkasse-oberlausitz-niederschlesien.de	Adguard-Banks-White
sparkasse-oberpfalz-nord.de	Adguard-Banks-White
sparkasse-odenwaldkreis.de	Adguard-Banks-White
sparkasse-offenbach.de	Adguard-Banks-White
sparkasse-offenburg.de	Adguard-Banks-White
sparkasse-olpe.de	Adguard-Banks-White
sparkasse-opr.de	Adguard-Banks-White
sparkasse-osnabrueck.de	Adguard-Banks-White
sparkasse-osterode.de	Adguard-Banks-White
sparkasse-paderborn-detmold.de	Adguard-Banks-White
sparkasse-parchim.de	Adguard-Banks-White
sparkasse-passau.de	Adguard-Banks-White
sparkasse-pfaffenhofen.de	Adguard-Banks-White
sparkasse-pforzheim-calw.de	Adguard-Banks-White
sparkasse-pm.de	Adguard-Banks-White
banking.sparkasse-prignitz.de	Adguard-Banks-White
sparkasse-radevormwald.de	Adguard-Banks-White
sparkasse-re.de	Adguard-Banks-White
sparkasse-regen-viechtach.de	Adguard-Banks-White
sparkasse-regensburg.de	Adguard-Banks-White
sparkasse-rhein-haardt.de	Adguard-Banks-White
sparkasse-rhein-nahe.de	Adguard-Banks-White
sparkasse-rhein-neckar-nord.de	Adguard-Banks-White
sparkasse-rheine.de	Adguard-Banks-White
sparkasse-rottal-inn.de	Adguard-Banks-White
sparkasse-rottweil.de	Adguard-Banks-White
sparkasse-saalfeld-rudolstadt.de	Adguard-Banks-White
sparkasse-saarbruecken.de	Adguard-Banks-White
sparkasse-schongau.de	Adguard-Banks-White
sparkasse-schwandorf.de	Adguard-Banks-White
sparkasse-schwedt.de	Adguard-Banks-White
sparkasse-schwelm.de	Adguard-Banks-White
sparkasse-schwerte.de	Adguard-Banks-White
sparkasse-sha.de	Adguard-Banks-White
sparkasse-siegen.de	Adguard-Banks-White
sparkasse-soest.de	Adguard-Banks-White
sparkasse-solingen.de	Adguard-Banks-White
sparkasse-spree-neisse.de	Adguard-Banks-White
sparkasse-sprockhoevel.de	Adguard-Banks-White
sparkasse-st-blasien.de	Adguard-Banks-White
sparkasse-stade-altes-land.de	Adguard-Banks-White
sparkasse-starkenburg.de	Adguard-Banks-White
sparkasse-staufen-breisach.de	Adguard-Banks-White
sparkasse-straelen.de	Adguard-Banks-White
sparkasse-suedwestpfalz.de	Adguard-Banks-White
sparkasse-suew.de	Adguard-Banks-White
sparkasse-sw.de	Adguard-Banks-White
sparkasse-tauberfranken.de	Adguard-Banks-White
sparkasse-trier.de	Adguard-Banks-White
sparkasse-uecker-randow.de	Adguard-Banks-White
sparkasse-uelzen-luechow-dannenberg.de	Adguard-Banks-White
sparkasse-ulm.de	Adguard-Banks-White
sparkasse-unnakamen.de	Adguard-Banks-White
sparkasse-unstrut-hainich.de	Adguard-Banks-White
sparkasse-vogtland.de	Adguard-Banks-White
sparkasse-vorderpfalz.de	Adguard-Banks-White
sparkasse-wa-fkb.de	Adguard-Banks-White
sparkasse-wasserburg.de	Adguard-Banks-White
sparkasse-wedel.de	Adguard-Banks-White
sparkasse-werl.de	Adguard-Banks-White
sparkasse-wermelskirchen.de	Adguard-Banks-White
sparkasse-werra-meissner.de	Adguard-Banks-White
sparkasse-westmuensterland.de	Adguard-Banks-White
sparkasse-wetter.de	Adguard-Banks-White
sparkasse-wetzlar.de	Adguard-Banks-White
sparkasse-wiehl.de	Adguard-Banks-White
sparkasse-wiesental.de	Adguard-Banks-White
sparkasse-wilhelmshaven.de	Adguard-Banks-White
sparkasse-witten.de	Adguard-Banks-White
sparkasse-wittenberg.de	Adguard-Banks-White
sparkasse-wittgenstein.de	Adguard-Banks-White
sparkasse-wolfach.de	Adguard-Banks-White
sparkasse-worms-alzey-ried.de	Adguard-Banks-White
sparkasse-wuppertal.de	Adguard-Banks-White
sparkasse-zollernalb.de	Adguard-Banks-White
sparkassedeggendorf.de	Adguard-Banks-White
sparkassemerzig-wadern.de	Adguard-Banks-White
spaw.de	Adguard-Banks-White
sperrer.de	Adguard-Banks-White
spk-aic-sob.de	Adguard-Banks-White
spk-arnstadt-ilmenau.de	Adguard-Banks-White
spk-aschaffenburg.de	Adguard-Banks-White
spk-barnim.de	Adguard-Banks-White
spk-bbg.de	Adguard-Banks-White
spk-bergkamen-boenen.de	Adguard-Banks-White
spk-buehl.de	Adguard-Banks-White
spk-burgenlandkreis.de	Adguard-Banks-White
spk-cham.de	Adguard-Banks-White
spk-chemnitz.de	Adguard-Banks-White
spk-elbe-elster.de	Adguard-Banks-White
spk-frg.de	Adguard-Banks-White
spk-gengenbach.de	Adguard-Banks-White
spk-gifhorn-wolfsburg.de	Adguard-Banks-White
spk-goettingen.de	Adguard-Banks-White
spk-hef.de	Adguard-Banks-White
spk-hennstedt-wesselburen.de	Adguard-Banks-White
spk-hohenlohekreis.de	Adguard-Banks-White
spk-in-ei.de	Adguard-Banks-White
spk-kg.de	Adguard-Banks-White
spk-laubach-hungen.de	Adguard-Banks-White
spk-luebeck.de	Adguard-Banks-White
spk-mecklenburg-nordwest.de	Adguard-Banks-White
spk-mecklenburg-strelitz.de	Adguard-Banks-White
spk-mittelholstein.de	Adguard-Banks-White
spk-mk.de	Adguard-Banks-White
spk-mm-li-mn.de	Adguard-Banks-White
spk-muenden.de	Adguard-Banks-White
spk-muldental.de	Adguard-Banks-White
spk-nbdm.de	Adguard-Banks-White
spk-ostunterfranken.de	Adguard-Banks-White
spk-rastatt-gernsbach.de	Adguard-Banks-White
spk-reichenau.de	Adguard-Banks-White
spk-ro-aib.de	Adguard-Banks-White
spk-salem.de	Adguard-Banks-White
spk-schaumburg.de	Adguard-Banks-White
spk-scheessel.de	Adguard-Banks-White
spk-suedholstein.de	Adguard-Banks-White
spk-swb.de	Adguard-Banks-White
spk-ts.de	Adguard-Banks-White
spk-uckermark.de	Adguard-Banks-White
spk-vorpommern.de	Adguard-Banks-White
spk-westholstein.de	Adguard-Banks-White
spk-zwickau.de	Adguard-Banks-White
spkam.de	Adguard-Banks-White
spked.de	Adguard-Banks-White
spkeo.de	Adguard-Banks-White
spkhb.de	Adguard-Banks-White
spkhw.de	Adguard-Banks-White
spkkm.de	Adguard-Banks-White
spkrb.de	Adguard-Banks-White
spkson.de	Adguard-Banks-White
spktw.de	Adguard-Banks-White
spreewaldbank.de	Adguard-Banks-White
ssk-bad-pyrmont.de	Adguard-Banks-White
ssk-bad-sachsa.de	Adguard-Banks-White
ssk-cuxhaven.de	Adguard-Banks-White
ssk-felsberg.de	Adguard-Banks-White
ssk-wunstorf.de	Adguard-Banks-White
sska.de	Adguard-Banks-White
sskbo.de	Adguard-Banks-White
sskborken.de	Adguard-Banks-White
sskduesseldorf.de	Adguard-Banks-White
sskm.de	Adguard-Banks-White
sskpw.de	Adguard-Banks-White
stadt-sparkasse-haan.de	Adguard-Banks-White
stadtsparkasse-barsinghausen.de	Adguard-Banks-White
stadtsparkasse-bocholt.de	Adguard-Banks-White
stadtsparkasse-burgdorf.de	Adguard-Banks-White
stadtsparkasse-emmerich-rees.de	Adguard-Banks-White
stadtsparkasse-grebenstein.de	Adguard-Banks-White
stadtsparkasse-haltern.de	Adguard-Banks-White
stadtsparkasse-hilchenbach.de	Adguard-Banks-White
stadtsparkasse-kaiserslautern.de	Adguard-Banks-White
stadtsparkasse-lengerich.de	Adguard-Banks-White
stadtsparkasse-oberhausen.de	Adguard-Banks-White
stadtsparkasse-rahden.de	Adguard-Banks-White
stadtsparkasse-remscheid.de	Adguard-Banks-White
stadtsparkasse-schmallenberg.de	Adguard-Banks-White
stadtsparkasse-schwalmstadt.de	Adguard-Banks-White
stadtsparkasse-versmold.de	Adguard-Banks-White
steylerbank.de	Adguard-Banks-White
sutorbank.de	Adguard-Banks-White
swkbank.de	Adguard-Banks-White
sylter-bank.de	Adguard-Banks-White
targobank.de	Adguard-Banks-White
taunussparkasse.de	Adguard-Banks-White
teba-kreditbank.de	Adguard-Banks-White
api.tech26.de	Adguard-Banks-White
meinkonto.tfbank.de	Adguard-Banks-White
umweltbank.de	Adguard-Banks-White
union-investment.de	Adguard-Banks-White
unionbank.de	Adguard-Banks-White
unsere-raiba.de	Adguard-Banks-White
unserevolksbank.de	Adguard-Banks-White
v-vb.de	Adguard-Banks-White
vakif-bank.de	Adguard-Banks-White
varengold.de	Adguard-Banks-White
vb-abi.de	Adguard-Banks-White
vb-alzey-worms.de	Adguard-Banks-White
vb-amelsbueren.de	Adguard-Banks-White
vb-ascheberg-herbern.de	Adguard-Banks-White
vb-aw.de	Adguard-Banks-White
vb-bad-saulgau.de	Adguard-Banks-White
vb-bbs.de	Adguard-Banks-White
vb-bia.de	Adguard-Banks-White
vb-bocholt.de	Adguard-Banks-White
vb-bochumwitten.de	Adguard-Banks-White
vb-brandoberndorf.de	Adguard-Banks-White
vb-breisgau-sued.de	Adguard-Banks-White
vb-bruchsal-bretten.de	Adguard-Banks-White
vb-delitzsch.de	Adguard-Banks-White
vb-eg.de	Adguard-Banks-White
vb-elsen-wewer-borchen.de	Adguard-Banks-White
vb-emstal.de	Adguard-Banks-White
vb-eow.de	Adguard-Banks-White
vb-flein-talheim.de	Adguard-Banks-White
vb-gemen.de	Adguard-Banks-White
vb-gescher.de	Adguard-Banks-White
vb-grebenhain.de	Adguard-Banks-White
vb-halle.de	Adguard-Banks-White
vb-haltern.de	Adguard-Banks-White
vb-heimbach.de	Adguard-Banks-White
vb-hohenlimburg.de	Adguard-Banks-White
vb-hohenlohe.de	Adguard-Banks-White
vb-ioml.de	Adguard-Banks-White
vb-is.de	Adguard-Banks-White
vb-iw.de	Adguard-Banks-White
vb-jerichower-land.de	Adguard-Banks-White
vb-kawe.de	Adguard-Banks-White
vb-kempen.de	Adguard-Banks-White
vb-laichinger-alb.de	Adguard-Banks-White
vb-lauterecken.de	Adguard-Banks-White
vb-limbach.de	Adguard-Banks-White
vb-loebau-zittau.de	Adguard-Banks-White
vb-marl-recklinghausen.de	Adguard-Banks-White
vb-mittelhessen.de	Adguard-Banks-White
vb-ml.de	Adguard-Banks-White
vb-modau.de	Adguard-Banks-White
vb-mosbach.de	Adguard-Banks-White
vb-niers.de	Adguard-Banks-White
vb-nordhuemmling.de	Adguard-Banks-White
vb-oberberg.de	Adguard-Banks-White
vb-piel.de	Adguard-Banks-White
vb-rb.de	Adguard-Banks-White
vb-rb-riedlingen.de	Adguard-Banks-White
vb-regensburg.de	Adguard-Banks-White
vb-reiste-eslohe.de	Adguard-Banks-White
vb-reutlingen.de	Adguard-Banks-White
vb-ruhrmitte.de	Adguard-Banks-White
vb-saarpfalz.de	Adguard-Banks-White
vb-sauerland.de	Adguard-Banks-White
vb-schermbeck-internetbanking.de	Adguard-Banks-White
vb-schnathorst.de	Adguard-Banks-White
vb-selm-bork.de	Adguard-Banks-White
vb-senden.de	Adguard-Banks-White
vb-steineisingen.de	Adguard-Banks-White
vb-stutensee-weingarten.de	Adguard-Banks-White
vb-ue-saw.de	Adguard-Banks-White
vb-ueberherrn.de	Adguard-Banks-White
vb-ueberwald-gorxheimertal.de	Adguard-Banks-White
vb-untere-saar.de	Adguard-Banks-White
vb-waltrop.de	Adguard-Banks-White
vb-westenholz.de	Adguard-Banks-White
vb-westerkappeln.de	Adguard-Banks-White
vb-westerstede.de	Adguard-Banks-White
vb-wickede.de	Adguard-Banks-White
vb-wilferdingen-keltern.de	Adguard-Banks-White
vb-wittingen-kloetze.de	Adguard-Banks-White
vb3.de	Adguard-Banks-White
vbank.de	Adguard-Banks-White
vbbakum.de	Adguard-Banks-White
vbbh.de	Adguard-Banks-White
vbboesel.de	Adguard-Banks-White
vbbraunlage.de	Adguard-Banks-White
vbbremennord.de	Adguard-Banks-White
vbbs.de	Adguard-Banks-White
vbcloppenburg.de	Adguard-Banks-White
vbdammer-berge.de	Adguard-Banks-White
vbdel.de	Adguard-Banks-White
vbdessau.de	Adguard-Banks-White
vbdh.de	Adguard-Banks-White
vbdonw.de	Adguard-Banks-White
vbemstek.de	Adguard-Banks-White
vbesens.de	Adguard-Banks-White
vbessen-cappeln.de	Adguard-Banks-White
vbeutin.de	Adguard-Banks-White
vbfoa.de	Adguard-Banks-White
vbga.de	Adguard-Banks-White
vbgebhardshain.de	Adguard-Banks-White
vbgeest.de	Adguard-Banks-White
vbghb.de	Adguard-Banks-White
vbgn.de	Adguard-Banks-White
vbhaaren.de	Adguard-Banks-White
vbhalle.de	Adguard-Banks-White
vbhaseluenne.de	Adguard-Banks-White
vbhawa.de	Adguard-Banks-White
vbheiden.de	Adguard-Banks-White
vbhildesheimerboerde.de	Adguard-Banks-White
vbhnr.de	Adguard-Banks-White
vbimharz.de	Adguard-Banks-White
vbkm.de	Adguard-Banks-White
vbkraichgau.de	Adguard-Banks-White
vbkrefeld.de	Adguard-Banks-White
vblastrup.de	Adguard-Banks-White
vblh.de	Adguard-Banks-White
vbloeningen.de	Adguard-Banks-White
vblohne-muehlen.de	Adguard-Banks-White
vblr.de	Adguard-Banks-White
vbneuenkirchen-voerden.de	Adguard-Banks-White
vbnh.de	Adguard-Banks-White
vbnienburg.de	Adguard-Banks-White
vbohz.de	Adguard-Banks-White
vbos-nordland.de	Adguard-Banks-White
vboyten.de	Adguard-Banks-White
vbpf.de	Adguard-Banks-White
vbrb.de	Adguard-Banks-White
vbrbinvorpommern.de	Adguard-Banks-White
vbrn.de	Adguard-Banks-White
vbsdn.de	Adguard-Banks-White
vbsolling.de	Adguard-Banks-White
vbspn.de	Adguard-Banks-White
vbsprockhoevel.de	Adguard-Banks-White
vbstendal.de	Adguard-Banks-White
vbsuedemsland.de	Adguard-Banks-White
vbsuedheide.de	Adguard-Banks-White
vbu-volksbank.de	Adguard-Banks-White
vbvechta.de	Adguard-Banks-White
vbvisbek.de	Adguard-Banks-White
vbwildeshauser-geest.de	Adguard-Banks-White
vbwinsenermarsch.de	Adguard-Banks-White
vbwolgast.de	Adguard-Banks-White
vereinigte-sparkassen.de	Adguard-Banks-White
vereinigtevolksbankeg.de	Adguard-Banks-White
vereinte-volksbank.de	Adguard-Banks-White
vlvb.de	Adguard-Banks-White
voba-aschaffenburg.de	Adguard-Banks-White
voba-aw.de	Adguard-Banks-White
voba-bigge-lenne.de	Adguard-Banks-White
voba-bkh.de	Adguard-Banks-White
voba-bl.de	Adguard-Banks-White
voba-blaubeuren.de	Adguard-Banks-White
voba-breisgau-nord.de	Adguard-Banks-White
voba-deisslingen.de	Adguard-Banks-White
voba-eg.de	Adguard-Banks-White
voba-ermstal-alb.de	Adguard-Banks-White
voba-glm.de	Adguard-Banks-White
voba-heuchelheim.de	Adguard-Banks-White
voba-hoba.de	Adguard-Banks-White
voba-kw.de	Adguard-Banks-White
voba-mainspitze.de	Adguard-Banks-White
voba-mg.de	Adguard-Banks-White
voba-moeckmuehl.de	Adguard-Banks-White
voba-msw.de	Adguard-Banks-White
voba-niedergrafschaft.de	Adguard-Banks-White
voba-ober-moerlen.de	Adguard-Banks-White
voba-online.de	Adguard-Banks-White
voba-owd.de	Adguard-Banks-White
voba-rheinahreifel.de	Adguard-Banks-White
voba-rheinboellen.de	Adguard-Banks-White
voba-rll.de	Adguard-Banks-White
voba-rnh.de	Adguard-Banks-White
voba-sbh.de	Adguard-Banks-White
voba-schwanewede.de	Adguard-Banks-White
voba-seligenstadt.de	Adguard-Banks-White
voba-sh.de	Adguard-Banks-White
voba-si.de	Adguard-Banks-White
voba-vorbach-tauber.de	Adguard-Banks-White
voba-worpswede.de	Adguard-Banks-White
voba-zuff.de	Adguard-Banks-White
vobabm.de	Adguard-Banks-White
vobadhk.de	Adguard-Banks-White
vobadill.de	Adguard-Banks-White
vobadin.de	Adguard-Banks-White
vobadirekt.de	Adguard-Banks-White
vobadreieich.de	Adguard-Banks-White
vobaeg.de	Adguard-Banks-White
vobahe.de	Adguard-Banks-White
vobahf.de	Adguard-Banks-White
vobak.de	Adguard-Banks-White
vobakl.de	Adguard-Banks-White
vobakn.de	Adguard-Banks-White
vobamt.de	Adguard-Banks-White
vobasandhofen.de	Adguard-Banks-White
vobawhv.de	Adguard-Banks-White
volksbank-adelebsen.de	Adguard-Banks-White
volksbank-aktiv.de	Adguard-Banks-White
volksbank-albstadt.de	Adguard-Banks-White
volksbank-allgaeu-oberschwaben.de	Adguard-Banks-White
volksbank-altshausen.de	Adguard-Banks-White
volksbank-ammerbuch.de	Adguard-Banks-White
volksbank-anroechte.de	Adguard-Banks-White
volksbank-backnang.de	Adguard-Banks-White
volksbank-baden-baden-rastatt.de	Adguard-Banks-White
volksbank-baumberge.de	Adguard-Banks-White
volksbank-berg.de	Adguard-Banks-White
volksbank-bi-gt.de	Adguard-Banks-White
volksbank-boenen.de	Adguard-Banks-White
volksbank-boerde-bernburg.de	Adguard-Banks-White
volksbank-brawo.de	Adguard-Banks-White
volksbank-brenztal.de	Adguard-Banks-White
volksbank-buehl.de	Adguard-Banks-White
volksbank-butzbach.de	Adguard-Banks-White
volksbank-chemnitz.de	Adguard-Banks-White
volksbank-daaden.de	Adguard-Banks-White
volksbank-deggingen.de	Adguard-Banks-White
volksbank-demmin.de	Adguard-Banks-White
volksbank-dettenhausen.de	Adguard-Banks-White
volksbank-dh.de	Adguard-Banks-White
volksbank-dingolfing.de	Adguard-Banks-White
volksbank-dornstetten.de	Adguard-Banks-White
volksbank-dresden-bautzen.de	Adguard-Banks-White
volksbank-dueren.de	Adguard-Banks-White
volksbank-eg.de	Adguard-Banks-White
volksbank-eifel.de	Adguard-Banks-White
volksbank-eppertshausen.de	Adguard-Banks-White
volksbank-erft.de	Adguard-Banks-White
volksbank-erle.de	Adguard-Banks-White
volksbank-esslingen.de	Adguard-Banks-White
volksbank-ettlingen.de	Adguard-Banks-White
volksbank-feldatal.de	Adguard-Banks-White
volksbank-filder.de	Adguard-Banks-White
volksbank-fntt.de	Adguard-Banks-White
volksbank-forchheim.de	Adguard-Banks-White
volksbank-franken.de	Adguard-Banks-White
volksbank-freiburg.de	Adguard-Banks-White
volksbank-gardelegen.de	Adguard-Banks-White
volksbank-goeppingen.de	Adguard-Banks-White
volksbank-greven.de	Adguard-Banks-White
volksbank-griesheim.de	Adguard-Banks-White
volksbank-hameln-stadthagen.de	Adguard-Banks-White
volksbank-hamm.de	Adguard-Banks-White
volksbank-heilbronn.de	Adguard-Banks-White
volksbank-heiligenstadt.de	Adguard-Banks-White
volksbank-heinsberg.de	Adguard-Banks-White
volksbank-hellweg.de	Adguard-Banks-White
volksbank-heuberg.de	Adguard-Banks-White
volksbank-hochrhein.de	Adguard-Banks-White
volksbank-hunsrueck-nahe.de	Adguard-Banks-White
volksbank-im-mk.de	Adguard-Banks-White
volksbank-immenstadt.de	Adguard-Banks-White
volksbank-jever.de	Adguard-Banks-White
volksbank-karlsruhe.de	Adguard-Banks-White
volksbank-kassel-goettingen.de	Adguard-Banks-White
volksbank-kierspe.de	Adguard-Banks-White
volksbank-kirchheim-nuertingen.de	Adguard-Banks-White
volksbank-kirnau.de	Adguard-Banks-White
volksbank-koeln-bonn.de	Adguard-Banks-White
volksbank-krp.de	Adguard-Banks-White
volksbank-kurpfalz.de	Adguard-Banks-White
volksbank-lahr.de	Adguard-Banks-White
volksbank-langendernbach.de	Adguard-Banks-White
volksbank-lindenberg.de	Adguard-Banks-White
volksbank-lingen.de	Adguard-Banks-White
volksbank-ludwigsburg.de	Adguard-Banks-White
volksbank-luebeck.de	Adguard-Banks-White
volksbank-magdeburg.de	Adguard-Banks-White
volksbank-magstadt.de	Adguard-Banks-White
volksbank-messkirch.de	Adguard-Banks-White
volksbank-mitte.de	Adguard-Banks-White
volksbank-mittleres-erzgebirge.de	Adguard-Banks-White
volksbank-mittweida.de	Adguard-Banks-White
volksbank-montabaur.de	Adguard-Banks-White
volksbank-muellheim.de	Adguard-Banks-White
volksbank-muensingen.de	Adguard-Banks-White
volksbank-neckartal.de	Adguard-Banks-White
volksbank-nordschwarzwald.de	Adguard-Banks-White
volksbank-nottuln.de	Adguard-Banks-White
volksbank-oldenburg.de	Adguard-Banks-White
volksbank-ortenau.de	Adguard-Banks-White
volksbank-osnabrueck.de	Adguard-Banks-White
volksbank-pfullendorf.de	Adguard-Banks-White
volksbank-pirna.de	Adguard-Banks-White
volksbank-plochingen.de	Adguard-Banks-White
volksbank-raiffeisenbank-rhoen-grabfeld.de	Adguard-Banks-White
volksbank-remseck.de	Adguard-Banks-White
volksbank-rhein-wehra.de	Adguard-Banks-White
volksbank-riesa.de	Adguard-Banks-White
volksbank-rot.de	Adguard-Banks-White
volksbank-rottweil.de	Adguard-Banks-White
volksbank-schupbach.de	Adguard-Banks-White
volksbank-staufen.de	Adguard-Banks-White
volksbank-stormarn.de	Adguard-Banks-White
volksbank-straubing.de	Adguard-Banks-White
volksbank-strohgaeu.de	Adguard-Banks-White
volksbank-stuttgart.de	Adguard-Banks-White
volksbank-sulmtal.de	Adguard-Banks-White
volksbank-trier.de	Adguard-Banks-White
volksbank-trossingen.de	Adguard-Banks-White
volksbank-ueberlingen.de	Adguard-Banks-White
volksbank-ulm-biberach.de	Adguard-Banks-White
volksbank-ulrichstein.de	Adguard-Banks-White
volksbank-vogtland.de	Adguard-Banks-White
volksbank-vor-ort.de	Adguard-Banks-White
volksbank-weinheim.de	Adguard-Banks-White
volksbank-welzheim.de	Adguard-Banks-White
volksbank-weschnitztal.de	Adguard-Banks-White
volksbank-westrhauderfehn.de	Adguard-Banks-White
volksbank-wissmar.de	Adguard-Banks-White
volksbank-wittenberg.de	Adguard-Banks-White
volksbank-zwickau.de	Adguard-Banks-White
volksbankelsterland.de	Adguard-Banks-White
volksbanking.de	Adguard-Banks-White
volkswagenbank.de	Adguard-Banks-White
vorne.de	Adguard-Banks-White
vr-amberg.de	Adguard-Banks-White
vr-b.de	Adguard-Banks-White
vr-bank-alzenau.de	Adguard-Banks-White
vr-bank-alzey-land-schwabenheim.de	Adguard-Banks-White
vr-bank-dinklage-steinfeld.de	Adguard-Banks-White
vr-bank-ehh.de	Adguard-Banks-White
vr-bank-erding.de	Adguard-Banks-White
vr-bank-landau.de	Adguard-Banks-White
vr-bank-lua.de	Adguard-Banks-White
vr-bank-mittelsachsen.de	Adguard-Banks-White
vr-bank-muenchen-land.de	Adguard-Banks-White
vr-bank-muldental.de	Adguard-Banks-White
vr-bank-nordrhoen.de	Adguard-Banks-White
vr-bank-online.de	Adguard-Banks-White
vr-bank-passau.de	Adguard-Banks-White
vr-bank-sw.de	Adguard-Banks-White
vr-bank-wuerzburg.de	Adguard-Banks-White
vr-banknordeifel.de	Adguard-Banks-White
vr-bankverein.de	Adguard-Banks-White
vr-bayernmitte.de	Adguard-Banks-White
vr-burglengenfeld.de	Adguard-Banks-White
vr-dachau.de	Adguard-Banks-White
vr-dm.de	Adguard-Banks-White
vr-ff.de	Adguard-Banks-White
vr-genobank.de	Adguard-Banks-White
vr-glauchau.de	Adguard-Banks-White
vr-internet.de	Adguard-Banks-White
vr-li.de	Adguard-Banks-White
vr-lif-ebn.de	Adguard-Banks-White
vr-ll.de	Adguard-Banks-White
vr-meissen.de	Adguard-Banks-White
vr-memmingen.de	Adguard-Banks-White
vr-mfr.de	Adguard-Banks-White
vr-miba.de	Adguard-Banks-White
vr-neuburg-rain.de	Adguard-Banks-White
vr-nms.de	Adguard-Banks-White
vr-nordoberpfalz.de	Adguard-Banks-White
vr-ofrm.de	Adguard-Banks-White
vr-partnerbank.de	Adguard-Banks-White
vr-plus.de	Adguard-Banks-White
vr-schluechtern-birstein.de	Adguard-Banks-White
vr-tuebingen.de	Adguard-Banks-White
vr-vilshofen.de	Adguard-Banks-White
vr-werdenfels.de	Adguard-Banks-White
vrb-eisenach.de	Adguard-Banks-White
vrb-meinebank.de	Adguard-Banks-White
vrb-niederschlesien.de	Adguard-Banks-White
vrb-uckermark-randow.de	Adguard-Banks-White
vrb-westthueringen.de	Adguard-Banks-White
vrbank.de	Adguard-Banks-White
vrbank-alsheim.de	Adguard-Banks-White
vrbank-am.de	Adguard-Banks-White
vrbank-bamberg.de	Adguard-Banks-White
vrbank-bayreuth-hof.de	Adguard-Banks-White
vrbank-biedglad.de	Adguard-Banks-White
vrbank-bsb.de	Adguard-Banks-White
vrbank-coburg.de	Adguard-Banks-White
vrbank-ellwangen.de	Adguard-Banks-White
vrbank-feuchtwangen-dinkelsbuehl.de	Adguard-Banks-White
vrbank-ffb.de	Adguard-Banks-White
vrbank-fl-sl.de	Adguard-Banks-White
vrbank-geo.de	Adguard-Banks-White
vrbank-hessenland.de	Adguard-Banks-White
vrbank-hg.de	Adguard-Banks-White
vrbank-ihn.de	Adguard-Banks-White
vrbank-im-enzkreis.de	Adguard-Banks-White
vrbank-isar-vils.de	Adguard-Banks-White
vrbank-kf-oal.de	Adguard-Banks-White
vrbank-mittelhaardt.de	Adguard-Banks-White
vrbank-mkb.de	Adguard-Banks-White
vrbank-obb-so.de	Adguard-Banks-White
vrbank-ostalb.de	Adguard-Banks-White
vrbank-rendsburg.de	Adguard-Banks-White
vrbank-rv-wgt.de	Adguard-Banks-White
vrbank-sha.de	Adguard-Banks-White
vrbank-suedpfalz.de	Adguard-Banks-White
vrbank-suedthueringen.de	Adguard-Banks-White
vrbank-suedwestpfalz.de	Adguard-Banks-White
vrbank-sww.de	Adguard-Banks-White
vrbank-untertaunus.de	Adguard-Banks-White
vrbank-weimar.de	Adguard-Banks-White
vrbankgl.de	Adguard-Banks-White
vrbankht.de	Adguard-Banks-White
ssl.vrbanknet.de	Adguard-Banks-White
vrbankniebuell.de	Adguard-Banks-White
vrbanknuernberg.de	Adguard-Banks-White
vrben.de	Adguard-Banks-White
vrbfw.de	Adguard-Banks-White
vrbk.de	Adguard-Banks-White
vrbleinebergland.de	Adguard-Banks-White
vrbprignitz.de	Adguard-Banks-White
vrgenobank-fulda.de	Adguard-Banks-White
vrkt.de	Adguard-Banks-White
vrla.de	Adguard-Banks-White
vrleonberg.de	Adguard-Banks-White
vrmeinebank.de	Adguard-Banks-White
vrnu.de	Adguard-Banks-White
vrsta.de	Adguard-Banks-White
vrwm.de	Adguard-Banks-White
vspk-neustadt.de	Adguard-Banks-White
vtb-direktbank.de	Adguard-Banks-White
vtbdirekt.de	Adguard-Banks-White
vvb-maingau.de	Adguard-Banks-White
vvrb.de	Adguard-Banks-White
w-saarplus.de	Adguard-Banks-White
waldecker-bank.de	Adguard-Banks-White
warburg-bank.de	Adguard-Banks-White
wartburg-sparkasse.de	Adguard-Banks-White
weberbank.de	Adguard-Banks-White
wespa.de	Adguard-Banks-White
westerwaldbank.de	Adguard-Banks-White
westkreis.de	Adguard-Banks-White
winterbacher-bank.de	Adguard-Banks-White
winterlinger-bank.de	Adguard-Banks-White
wirecardbank.de	Adguard-Banks-White
wuestenrot.de	Adguard-Banks-White
wuestenrotdirect.de	Adguard-Banks-White
wvb.de	Adguard-Banks-White
ww-ag.de	Adguard-Banks-White
xn--httenberger-bank-jzb.de	Adguard-Banks-White
ziraatbank.de	Adguard-Banks-White
danskebank.dk	Adguard-Banks-White
jutlander-netbank.dk	Adguard-Banks-White
jyskebank.dk	Adguard-Banks-White
mitnykredit.dk	Adguard-Banks-White
nordeanetbank.dk	Adguard-Banks-White
nykredit.dk	Adguard-Banks-White
sydbank.dk	Adguard-Banks-White
mirror.cedia.org.ec	Chris-Whitelist
webtransparency.cs.princeton.edu	Chris-Whitelist
sans.edu	Chris-Whitelist
bigbank.ee	Adguard-Banks-White
www2.danskebank.ee	Adguard-Banks-White
tikker.emta.ee	Adguard-Sensitive-White
i-pank.krediidipank.ee	Adguard-Banks-White
i-pank2.krediidipank.ee	Adguard-Banks-White
lhv.ee	Adguard-Banks-White
paypal-topup.ee	Adguard-Sensitive-White
id.pilet.ee	Adguard-Sensitive-White
seb.ee	Adguard-Banks-White
swedbank.ee	Adguard-Banks-White
tbb.ee	Adguard-Banks-White
alahlynet.com.eg	Adguard-Banks-White
emiratesnbd.com.eg	Adguard-Banks-White
nbe.com.eg	Adguard-Banks-White
bancopopular.es	Adguard-Banks-White
bancosantander.es	Adguard-Banks-White
bankia.es	Adguard-Banks-White
bbva.es	Adguard-Banks-White
cajamar.es	Adguard-Banks-White
deutsche-bank.es	Adguard-Banks-White
financialfood.es	UT1-Finance
agenciatributaria.gob.es	Adguard-Sensitive-White
ing.es	Adguard-Banks-White
ingdirect.es	Adguard-Banks-White
portal.lacaixa.es	Adguard-Banks-White
liberbank.es	Adguard-Banks-White
openbank.es	Adguard-Banks-White
selfbank.es	Adguard-Banks-White
targobank.es	Adguard-Banks-White
triodos.es	Adguard-Banks-White
unicaja.es	Adguard-Banks-White
unicajabanco.es	Adguard-Banks-White
wizink.es	Adguard-Banks-White
1password.eu	Adguard-Sensitive-White
www.antonioli.eu	Adguard-Mac-White
ib.baltikums.eu	Adguard-Banks-White
bitwarden.eu	Adguard-Sensitive-White
botvrij.eu	Chris-Whitelist
online.citi.eu	Adguard-Banks-White
cdc.daikin.eu	Adguard-Android-White
e-norvik.eu	Adguard-Banks-White
ib.expobank.eu	Adguard-Banks-White
financialinclusioneurope.eu	UT1-Finance
financialobserver.eu	UT1-Finance
financialreports.eu	UT1-Finance
h3x.eu	Chris-Whitelist
epayment.nets.eu	Adguard-Banks-White
ident.nets.eu	Adguard-Banks-White
acs-visa.norvik.eu	Adguard-Banks-White
onlinebanking-herzogpark.eu	Adguard-Banks-White
secure.payza.eu	Adguard-Banks-White
ib.pnbbanka.eu	Adguard-Banks-White
acs.sia.eu	Adguard-Banks-White
client.simplecoin.eu	Adguard-Banks-White
unicreditbanking.eu	Adguard-Banks-White
verkkopankki2.danskebank.fi	Adguard-Banks-White
www4.handelsbanken.fi	Adguard-Banks-White
hypo.fi	Adguard-Banks-White
hypopankki.fi	Adguard-Banks-White
verkkopalkka.maventa.fi	Adguard-Banks-White
nordea.fi	Adguard-Banks-White
omasp.fi	Adguard-Banks-White
op.fi	Adguard-Banks-White
poppankki.fi	Adguard-Banks-White
s-pankki.fi	Adguard-Banks-White
saastopankki.fi	Adguard-Banks-White
secure.seligson.fi	Adguard-Banks-White
www.bd.finance	Adguard-Banks-White
compound.finance	Adguard-Banks-White
spero.financial	UT1-Finance
abe-infoservice.fr	UT1-Finance
ag2rlamondiale.fr	UT1-Finance
bourse.aol.fr	UT1-Finance
avenuedesinvestisseurs.fr	UT1-Finance
axa.fr	UT1-Finance
banquepopulaire.fr	Adguard-Banks-White
bourse.fr	UT1-Finance
boursedirect.fr	UT1-Finance
boursica.fr	UT1-Finance
bpifrance.fr	UT1-Finance
caisse-epargne.fr	Adguard-Banks-White
cetelem.fr	UT1-Finance
cic.fr	Adguard-Banks-White
cortalconsors.fr	UT1-Finance
credit-agricole.fr	Adguard-Banks-White
creditmutuel.fr	Adguard-Banks-White
efinancialcareers.fr	UT1-Finance
fortuneo.fr	Adguard-Banks-White, UT1-Finance
free.fr	Chris-Whitelist
goodvest.fr	UT1-Finance
hsbc.fr	Adguard-Banks-White
iforex.fr	UT1-Finance
ingdirect.fr	Adguard-Banks-White
investir.fr	UT1-Finance
labanquepostale.fr	Adguard-Banks-White
lacotebleue.fr	UT1-Finance
bourse.latribune.fr	UT1-Finance
secure.lcl.fr	Adguard-Banks-White
bourse.lefigaro.fr	UT1-Finance
lemoneymag.fr	UT1-Finance
lepoint.fr	Chris-Whitelist
bourse.lesechos.fr	UT1-Finance
bourse.lexpress.fr	UT1-Finance
bourse.m6.fr	UT1-Finance
oddo.fr	Adguard-Banks-White
societegenerale.fr	Adguard-Banks-White
bourse.tf1.fr	UT1-Finance
trader-forex.fr	UT1-Finance
ftp.ut-capitole.fr	Chris-Whitelist
bourse.votreargent.fr	UT1-Finance
stats.gallery	MMoti
da.gd	Chris-Whitelist
bankonline.ge	Adguard-Banks-White
businessonline.ge	Adguard-Banks-White
e-commerce.cartubank.ge	Adguard-Banks-White
ebanking.ge	Adguard-Banks-White
gc3d.georgiancard.ge	Adguard-Banks-White
ibank.ge	Adguard-Banks-White
libertybank.ge	Adguard-Banks-White
libertypay.ge	Adguard-Banks-White
online.procreditbank.ge	Adguard-Banks-White
tbconline.ge	Adguard-Banks-White
securepay.ufc.ge	Adguard-Banks-White
goo.gl	Chris-Whitelist, Pi-DNS
goog	Chris-Whitelist
gov	Chris-Whitelist
alpha.gr	Adguard-Banks-White
ziraatbank.com.gr	Adguard-Banks-White
eurobank.gr	Adguard-Banks-White
nbg.gr	Adguard-Banks-White
void.gr	Chris-Whitelist
winbank.gr	Adguard-Banks-White
hsbc.com.hk	Adguard-Banks-White
ebank.addiko.hr	Adguard-Banks-White
ib.agrambanka.hr	Adguard-Banks-White
evaba.com.hr	Adguard-Banks-White
crobanet.croatiabanka.hr	Adguard-Banks-White
george.erstebank.hr	Adguard-Banks-White
netbanking.erstebank.hr	Adguard-Banks-White
ibg.hpb.hr	Adguard-Banks-White
ibg.ikb.hr	Adguard-Banks-White
imexnet.imexbanka.hr	Adguard-Banks-White
ib.kaba.hr	Adguard-Banks-White
net.kentbank.hr	Adguard-Banks-White
konet.kovanica.hr	Adguard-Banks-White
elementa.otpbanka.hr	Adguard-Banks-White
e.paba.hr	Adguard-Banks-White
pbz.hr	Adguard-Banks-White
klik.poba.hr	Adguard-Banks-White
rba.hr	Adguard-Banks-White
ibank.sabank.hr	Adguard-Banks-White
eb.sbhr.hr	Adguard-Banks-White
ebanking.slatinska-banka.hr	Adguard-Banks-White
zaba.hr	Adguard-Banks-White
bnpparibas.hu	Adguard-Banks-White
budapestbank.hu	Adguard-Banks-White
cetelem.hu	Adguard-Banks-White
cib.hu	Adguard-Banks-White
commerzbank.hu	Adguard-Banks-White
dtbank.hu	Adguard-Banks-White
login.erstebank.hu	Adguard-Banks-White
netbank.erstebank.hu	Adguard-Banks-White
kau.gov.hu	Adguard-Sensitive-White
granitbank.hu	Adguard-Banks-White
ingbank.hu	Adguard-Banks-White
kdb.hu	Adguard-Banks-White
kh.hu	Adguard-Banks-White
magnetbank.hu	Adguard-Banks-White
merkantil.hu	Adguard-Banks-White
mfb.hu	Adguard-Banks-White
mkb.hu	Adguard-Banks-White
mkbnetbankar.hu	Adguard-Banks-White
operbank.hu	Adguard-Banks-White
otpbank.hu	Adguard-Banks-White
otpbankdirekt.hu	Adguard-Banks-White
polgaribank.hu	Adguard-Banks-White
porschefinance.hu	Adguard-Banks-White
raiffeisen.hu	Adguard-Banks-White
sberbank.hu	Adguard-Banks-White
simplepay.hu	Adguard-Banks-White
netbank.takarek.hu	Adguard-Banks-White
takarekbank.hu	Adguard-Banks-White
unicreditbank.hu	Adguard-Banks-White
ib.bankbjb.co.id	Adguard-Banks-White
bankbsi.co.id	Adguard-Banks-White
bankdki.co.id	Adguard-Banks-White
ib.bankmandiri.co.id	Adguard-Banks-White
ibank.bankmandiri.co.id	Adguard-Banks-White
bni.co.id	Adguard-Banks-White
ib.bri.co.id	Adguard-Banks-White
bsm.co.id	Adguard-Banks-White
internetbanking.btn.co.id	Adguard-Banks-White
bukopin.co.id	Adguard-Banks-White
cimbclicks.co.id	Adguard-Banks-White
citibank.co.id	Adguard-Banks-White
danamon.co.id	Adguard-Banks-White
freelancer.co.id	Adguard-Sensitive-White
m2u.maybank.co.id	Adguard-Banks-White
dana.id	Adguard-Banks-White
flip.id	Adguard-Banks-White
we.id	Chris-Whitelist
aib.ie	Adguard-Banks-White
mcdevittfinancial.ie	UT1-Finance
revenue.ie	Adguard-Banks-White
ros.ie	Adguard-Banks-White
hb.aibank.co.il	Adguard-Banks-White
bankhapoalim.co.il	Adguard-Banks-White
hb2.bankleumi.co.il	Adguard-Banks-White
online.bankotsar.co.il	Adguard-Banks-White
discountbank.co.il	Adguard-Banks-White
fibi-online.co.il	Adguard-Banks-White
ivory.co.il	Pi-DNS
mizrahi-tefahot.co.il	Adguard-Banks-White
pay24.co.il	Adguard-Banks-White
hb.unionbank.co.il	Adguard-Banks-White
toss.im	Adguard-Banks-White
pay.amazon.in	Adguard-Banks-White
bajajfinserv.in	Adguard-Banks-White
canarabank.in	Adguard-Banks-White
axisbank.co.in	Adguard-Banks-White
citibank.co.in	Adguard-Banks-White
csb.co.in	Adguard-Banks-White
federalbank.co.in	Adguard-Banks-White
idbibank.co.in	Adguard-Banks-White
iobnet.co.in	Adguard-Banks-White
migs.mastercard.co.in	Adguard-Banks-White
obconline.co.in	Adguard-Banks-White
epay.unionbankofindia.co.in	Adguard-Banks-White
unionbankonline.co.in	Adguard-Banks-White
online.cosmosbank.in	Adguard-Banks-White
internet-banking.dbsbank.in	Adguard-Banks-White
signin.ebay.in	Adguard-Banks-White
geniusepay.in	Adguard-Banks-White
gov.in	Adguard-Sensitive-White
integratedfinancial.in	UT1-Finance
lnkd.in	Chris-Whitelist
payu.in	Adguard-Banks-White
pnbindia.in	Adguard-Banks-White
sbtonline.in	Adguard-Banks-White
syndicatebank.in	Adguard-Banks-White
syndonline.in	Adguard-Banks-White
dnscrypt.info	Chris-Whitelist
dnsdb.info	Chris-Whitelist
drivefinancial.info	UT1-Finance
funda.info	Chris-Whitelist
hartfordfinancialservicessucks.info	UT1-Finance
ibook.info	Chris-Whitelist, Chris-Connect
itools.info	Chris-Whitelist, Chris-Connect
mediserv.info	Adguard-Banks-White
mihi.info	Chris-Whitelist
public-dns.info	Chris-Whitelist
worldometers.info	Chris-Whitelist
cybersecurity.ink	Chris-Whitelist
centrifuge.io	Adguard-Banks-White
changehero.io	Adguard-Banks-White
app.dharma.io	Adguard-Banks-White
encipher.io	Chris-Whitelist
enpass.io	Adguard-Sensitive-White
gate.io	Adguard-Sensitive-White
github.io	Chris-Whitelist, AnuDeep
dsa.instadapp.io	Adguard-Banks-White
intercom.io	AnuDeep
ipinfi.io	Chris-Whitelist
ipinfo.io	Chris-Whitelist
mycred.io	Adguard-Banks-White
nexo.io	Adguard-Banks-White
nextdns.io	Chris-Whitelist
raindrop.io	Adguard-Mac-White
rebble.io	Chris-Whitelist
saplingapp.io	Chris-Whitelist
sbc.io	Chris-Whitelist
simplelogin.io	Adguard-Sensitive-White
simpleswap.io	Adguard-Banks-White
suspect-networks.io	Chris-Whitelist
zonefiles.io	Chris-Whitelist
ib.bank-maskan.ir	Adguard-Banks-White
ebanking.bankmellat.ir	Adguard-Banks-White
bmi.ir	Adguard-Banks-White
ib.bpi.ir	Adguard-Banks-White
baker.ebanksepah.ir	Adguard-Banks-White
ripb.parsian-bank.ir	Adguard-Banks-White
ibank.rqb.ir	Adguard-Banks-White
ib.tejaratbank.ir	Adguard-Banks-White
cryptostorm.is	Chris-Whitelist
freelancer.is	Adguard-Sensitive-White
adblock.mahakala.is	Chris-Whitelist
perfectmoney.is	Adguard-Banks-White
secure.bnl.it	Adguard-Banks-White
freelancer.co.it	Adguard-Sensitive-White
deutsche-bank.it	Adguard-Banks-White
hk.enel.it	Adguard-Android-White
msa.enel.it	Adguard-Android-White
fineco.it	Adguard-Banks-White
generali.it	Adguard-Banks-White
postacertificata.lextel.it	Adguard-Issues-White
modenaindiretta.it	Chris-Whitelist
placehold.it	AnuDeep
poste.it	Adguard-Banks-White
unicredit.it	Adguard-Banks-White
widiba.it	Adguard-Banks-White
rabobank.jobs	Chris-Whitelist
iij.ad.jp	MMoti
connect.auone.jp	Adguard-Sensitive-White
hokuyobank.co.jp	Adguard-Banks-White
mizuhobank.co.jp	Adguard-Banks-White
netbk.co.jp	Adguard-Banks-White
nttdocomo.co.jp	Adguard-Banks-White
rakuten-bank.co.jp	Adguard-Banks-White
resonabank.co.jp	Adguard-Banks-White
smbc.co.jp	Adguard-Banks-White
bbss.softbankbb.co.jp	Adguard-Sensitive-White
freelancer.jp	Adguard-Sensitive-White
jp-bank.japanpost.jp	Adguard-Banks-White
cms.tu.bk.mufg.jp	Adguard-Banks-White
line.naver.jp	Adguard-Issues-White
parasol.anser.ne.jp	Adguard-Banks-White
cfg.smt.docomo.ne.jp	Adguard-Sensitive-White
id.smt.docomo.ne.jp	Adguard-Sensitive-White
tknauth.spmode.ne.jp	Adguard-Issues-White
my.softbank.jp	Adguard-Sensitive-White
yamatofinancial.jp	UT1-Finance
acesglobal.co.ke	UT1-Finance
county2.riverbank.co.ke	Adguard-Banks-White
online.demirbank.kg	Adguard-Banks-White
optima24.kg	Adguard-Banks-White
gbank.rsk.kg	Adguard-Banks-White
cultureland.co.kr	Adguard-Banks-White
raonsecure.co.kr	Adguard-Sensitive-White
api-between.vcnc.co.kr	Adguard-Android-White
go.kr	Adguard-Sensitive-White
gov.kr	Adguard-Sensitive-White
kftc.or.kr	Adguard-Banks-White
alfabank.kz	Adguard-Banks-White
atf24.kz	Adguard-Banks-White
atfbank.kz	Adguard-Banks-White
bankastana.kz	Adguard-Banks-White
online.bankpozitiv.kz	Adguard-Banks-White
ib.bankrbk.kz	Adguard-Banks-White
bankrbk24.kz	Adguard-Banks-White
bcc.kz	Adguard-Banks-White
online.capitalbank.kz	Adguard-Banks-White
crediton.kz	Adguard-Banks-White
delta-online.kz	Adguard-Banks-White
halykpay.kz	Adguard-Banks-White
cabinet.hcsbk.kz	Adguard-Banks-White
homebank.kz	Adguard-Banks-White
ibank24.kz	Adguard-Banks-White
ioffice.kz	Adguard-Banks-White
kaspi.kz	Adguard-Banks-White
ibank.kzibank.kz	Adguard-Banks-White
moneyman.kz	Adguard-Banks-White
myaltyn.kz	Adguard-Banks-White
myhalyk.kz	Adguard-Banks-White
mykassa.kz	Adguard-Banks-White
onlinebank.kz	Adguard-Banks-White
onlinetsb.kz	Adguard-Banks-White
ib.pnbkaz.kz	Adguard-Banks-White
postbank.kz	Adguard-Banks-White
sberbank.kz	Adguard-Banks-White
shinhan.kz	Adguard-Banks-White
my.smartbank.kz	Adguard-Banks-White
online.vtb-bank.kz	Adguard-Banks-White
id.yandex.kz	Adguard-Sensitive-White
passport.yandex.kz	Adguard-Sensitive-White
arabbank.com.lb	Adguard-Banks-White
bankaudi.com.lb	Adguard-Banks-White
bankmed.com.lb	Adguard-Banks-White
byblosbank.com.lb	Adguard-Banks-White
creditbank.com.lb	Adguard-Banks-White
fnb.com.lb	Adguard-Banks-White
llb.li	Adguard-Banks-White
app.link	Chris-Whitelist
keenetic.link	Adguard-Issues-White
ebanking.amanabank.lk	Adguard-Banks-White
online.boc.lk	Adguard-Banks-White
virtualbanking.mcb.com.lk	Adguard-Banks-White
online.dfcc.lk	Adguard-Banks-White
online.hdfc.lk	Adguard-Banks-White
ebanking.hnb.lk	Adguard-Banks-White
onlinebanking.hnb.lk	Adguard-Banks-White
hsbc.lk	Adguard-Banks-White
www.indianbank.lk	Adguard-Banks-White
internetbank.nsb.lk	Adguard-Banks-White
www.payeasy.lk	Adguard-Banks-White
www.digital.peoplesbank.lk	Adguard-Banks-White
www.ebank.peoplesbank.lk	Adguard-Banks-White
sdbmobilec.sdb.lk	Adguard-Banks-White
ebankas.danskebank.lt	Adguard-Banks-White
ibank.lt	Adguard-Banks-White
margevicius.lt	Chris-Whitelist
seb.lt	Adguard-Banks-White
ib.swedbank.lt	Adguard-Banks-White
webbanking.bgl.lu	Adguard-Banks-White
online.citadele.lv	Adguard-Banks-White
ebanka.danskebank.lv	Adguard-Banks-White
e-pastabanka.lv	Adguard-Banks-White
ibank.ekp.lv	Adguard-Banks-White
secureshop.firstdata.lv	Adguard-Banks-White
i.rietumu.lv	Adguard-Banks-White
ibanka.seb.lv	Adguard-Banks-White
ib.swedbank.lv	Adguard-Banks-White
bit.ly	Chris-Whitelist, Pi-DNS
musical.ly	Adguard-Android-White
ow.ly	Chris-Whitelist, Pi-DNS
bmcedirect.ma	Adguard-Banks-White
gbp.ma	Adguard-Banks-White
24banking.md	Adguard-Banks-White
bcr.md	Adguard-Banks-White
24.comertbank.md	Adguard-Banks-White
cb.comertbank.md	Adguard-Banks-White
m24.comertbank.md	Adguard-Banks-White
pf.comertbank.md	Adguard-Banks-White
emobias.md	Adguard-Banks-White
maib.md	Adguard-Banks-White
micb.md	Adguard-Banks-White
eba.procreditbank.md	Adguard-Banks-White
da.victoriabank.md	Adguard-Banks-White
ssl.bblck.me	Chris-Whitelist
diskstation.me	Adguard-Sensitive-White
dscloud.me	Adguard-Sensitive-White
netbanking.erstebank.me	Adguard-Banks-White
i234.me	Adguard-Sensitive-White
myds.me	Adguard-Sensitive-White
next.me	Adguard-Banks-White
perevedi.me	Adguard-Banks-White
proton.me	Adguard-Sensitive-White
synology.me	Adguard-Sensitive-White
t.me	Chris-Whitelist
tikkie.me	Chris-Whitelist
twrp.me	Chris-Whitelist
vchecks.me	Adguard-Mac-White
ziraatbank.me	Adguard-Banks-White
cdn.stream.schibsted.media	Pi-DNS
halkbank.mk	Adguard-Banks-White
egolomt.mn	Adguard-Banks-White
ibank.mn	Adguard-Banks-White
dscloud.mobi	Adguard-Sensitive-White
j.mp	Chris-Whitelist, Pi-DNS
myip.ms	Chris-Whitelist
www.mcb.mu	Adguard-Banks-White
bankofmaldives.com.mv	Adguard-Banks-White
faisanet.mib.com.mv	Adguard-Banks-White
bbva.mx	Adguard-Banks-White
hsbc.com.mx	Adguard-Banks-White
nu.com.mx	Adguard-Banks-White
santander.com.mx	Adguard-Banks-White
allianceonline.com.my	Adguard-Banks-White
ambank.com.my	Adguard-Banks-White
ambank.amonline.com.my	Adguard-Banks-White
cimbclicks.com.my	Adguard-Banks-White
maybank2u.com.my	Adguard-Banks-White
mybsn.com.my	Adguard-Banks-White
triolan.name	Adguard-Issues-White
bci.nc	Adguard-Banks-White
bcinet.nc	Adguard-Banks-White
bnc.nc	Adguard-Banks-White
bnpparibas.nc	Adguard-Banks-White
sgcb.nc	Adguard-Banks-White
acompli.net	Adguard-Android-White
afrinic.net	Chris-Whitelist
ajkfinancial.net	UT1-Finance
apple-support.akadns.net	Chris-Whitelist
blobstore-apple.com.akadns.net	Chris-Whitelist
cdn-apple.com.akadns.net	Chris-Whitelist
gc-apple.com.akadns.net	Chris-Whitelist
icloud.com.akadns.net	Chris-Whitelist
itunes-apple.com.akadns.net	Chris-Whitelist
ls-apple.com.akadns.net	Chris-Connect
sonos.com.edgekey.net.globalredir.akadns.net	Chris-Whitelist
sonos.com-dsd.edgekey.net.globalredir.akadns.net	Chris-Whitelist
akamaihd.net	AnuDeep
akamaized.net	AnuDeep
americanfinancialsolutions.net	UT1-Finance
anti-ad.net	MMoti
apnic.net	Chris-Whitelist
apple-dns.net	Chris-Whitelist, Chris-Connect
arin.net	Chris-Whitelist
mb1.as50464.net	Adguard-Banks-White
mb2.as50464.net	Adguard-Banks-White
bro-tracker.atlassian.net	Chris-Whitelist
solicitudestarjetas.banesco.net	Adguard-Banks-White
login.banknetpower.net	Adguard-Banks-White
pay.best2pay.net	Adguard-Banks-White
bitstamp.net	Adguard-Banks-White
bourse.bnpparibas.net	UT1-Finance
nc.bnpparibas.net	Adguard-Banks-White
secure.bnpparibas.net	Adguard-Banks-White
www.brac.net	Adguard-Banks-White
brightcove.net	AnuDeep
cdn.cloudflare.net	AnuDeep
d2c8v52ll5s99u.cloudfront.net	AnuDeep
d2gatte9o95jao.cloudfront.net	AnuDeep
d2qxwxxauf5yxr.cloudfront.net	Chris-Whitelist
d3jdtixm7cvu7y.cloudfront.net	Chris-Whitelist
www.combank.net	Adguard-Banks-White
cpifinancial.net	UT1-Finance
darksky.net	Chris-Whitelist
dnssexy.net	Chris-Whitelist
dropbox.net	Chris-Whitelist
p13.dynect.net	Chris-Whitelist
apple.com.edgekey.net	Chris-Connect
icloud.com.edgekey.net	Chris-Whitelist
sonos.com.edgekey.net	Chris-Whitelist
sonos.com-dsd.edgekey.net	Chris-Whitelist
sonos.com-v1.edgekey.net	Chris-Whitelist
sonos.com-v2.edgekey.net	Chris-Whitelist
ax.phobos.apple.com.edgesuite.net	AnuDeep
emergingthreats.net	Chris-Whitelist
familyds.net	Adguard-Sensitive-White
global.ssl.fastly.net	Adguard-Android-White
fbtonline.net	Adguard-Banks-White
financial-hub.net	UT1-Finance
financial-strategy.net	UT1-Finance
financialexpress.net	UT1-Finance
financialholdingcorp.net	UT1-Finance
financialit.net	UT1-Finance
financialwellnessgroup.net	UT1-Finance
v.firebog.net	Chris-Whitelist
firstlightfinancial.net	UT1-Finance
chzbgr.com.c.footprint.net	Chris-Whitelist
freefinancialhelp.net	UT1-Finance
vanilla.futurecdn.net	Pi-DNS
adblock.gardar.net	Chris-Whitelist
checkout.gateline.net	Adguard-Banks-White
grenke.net	Adguard-Banks-White
bbc.gscontxt.net	Chris-Whitelist
gtld-servers.net	Chris-Whitelist
www.hajjfinance.net	Adguard-Banks-White
hfsfinancial.net	UT1-Finance
hosts-file.net	Chris-Whitelist
hpcloud.hp.net	Adguard-Issues-White
imgix.net	AnuDeep
intuitcdn.net	Chris-Whitelist
ituneslogin.net	Chris-Whitelist
jsdelivr.net	AnuDeep
ibank.kicb.net	Adguard-Banks-White
lacnic.net	Chris-Whitelist
apis.live.net	Adguard-Android-White
lyonfinancial.net	UT1-Finance
measurementlab.net	Chris-Whitelist
megabank.net	Adguard-Banks-White
memberdirect.net	Adguard-Banks-White
www.midlandbankbd.net	Adguard-Banks-White
home.mijngezondheid.net	Adguard-Sensitive-White
mortgage-rates-guide.net	UT1-Finance
az416426.vo.msecnd.net	Chris-Whitelist
netflix.net	Chris-Whitelist
nflximg.net	Chris-Whitelist
nflxvideo.net	Chris-Whitelist
nsone.net	Chris-Whitelist
office.net	AnuDeep
generalmotorscorporation.sc.omtrdc.net	Adguard-Android-White
nbcume.sc.omtrdc.net	Chris-Whitelist
bankofamerica.tt.omtrdc.net	Chris-Whitelist
ooklaserver.net	Chris-Whitelist
opera-proxy.net	Adguard-Issues-White
oxfordfinancial.net	UT1-Finance
clientconfig.passport.net	AnuDeep
ripe.net	Chris-Whitelist
api.rlje.net	AnuDeep
root-servers.net	Chris-Whitelist
safelinking.net	Pi-DNS
scansafe.net	Chris-Whitelist
imagesak.secureserver.net	AnuDeep
slack-redir.net	Pi-DNS
sma-trade.net	UT1-Finance
smart-financial-federal-cu.net	UT1-Finance
smartfinancialcentre.net	UT1-Finance
speedtest.net	Chris-Whitelist
sucuri.net	Chris-Whitelist
i.taatta.net	Adguard-Banks-White
taleo.net	Chris-Whitelist
termux.net	Adguard-Android-White
theworldexchange.net	Adguard-Banks-White
wget-mirrors.uceprotect.net	Chris-Whitelist
unicreditbanking.net	Adguard-Banks-White
univest.net	Adguard-Banks-White
dev.virtualearth.net	AnuDeep
t0.ssl.ak.tiles.virtualearth.net	AnuDeep
t0.ssl.ak.dynamic.tiles.virtualearth.net	AnuDeep
ok.webhop.net	Adguard-Sensitive-White
whatsapp.net	Chris-Whitelist, Adguard-Android-White
wideup.net	Adguard-Banks-White
nt2plus.blob.core.windows.net	Chris-Whitelist
card-form.diehard.yandex.net	Adguard-Banks-White
disk.yandex.net	Adguard-Android-White
mob.maps.yandex.net	Adguard-Android-White
mobile.yandex.net	Adguard-Android-White
voiseservices.yandex.net	Adguard-Android-White
content.yikyakapi.net	Adguard-Android-White
notify.yikyakapi.net	Adguard-Android-White
us-central-api.yikyakapi.net	Adguard-Android-White
celsius.network	Adguard-Banks-White
apple.news	Chris-Whitelist
9292.nl	Chris-Whitelist
abnamro.nl	Adguard-Banks-White, UT1-Finance
ad.nl	Chris-Whitelist
albelli.nl	Chris-Whitelist
asnbank.nl	Adguard-Banks-White
bankofscotland.nl	Adguard-Banks-White
buienradar.nl	Chris-Whitelist
crediteurope.nl	Adguard-Banks-White
digid.nl	Adguard-Banks-White
financialinvestigator.nl	UT1-Finance
financiallease.nl	UT1-Finance
financialleasezzp.nl	UT1-Finance
fstatic.nl	Chris-Whitelist
funda.nl	Chris-Whitelist
garantibank.nl	Adguard-Banks-White
glassdoor.nl	Chris-Whitelist
greenwheels.nl	Chris-Whitelist
gvb.nl	Chris-Whitelist
ictergezocht.nl	Chris-Whitelist
ideal.nl	Chris-Whitelist
ing.nl	Chris-Whitelist
internet.nl	Chris-Whitelist
kpn.nl	Chris-Whitelist
lloydsbank.nl	Adguard-Banks-White
mijnpazio.nl	Adguard-Sensitive-White
monsterboard.nl	Chris-Whitelist
nationalevacaturebank.nl	Chris-Whitelist
nederlandseloterij.nl	Chris-Whitelist
nextdoor.nl	Chris-Whitelist
nos.nl	Chris-Whitelist
npo.nl	Chris-Whitelist
npohosting.nl	Chris-Whitelist
npostart.nl	Chris-Whitelist
ns.nl	Chris-Whitelist
nt2plus.nl	Chris-Whitelist
nu.nl	Chris-Whitelist, Pi-DNS
nuon.nl	Chris-Whitelist
omroep.nl	Chris-Whitelist
ouderportaal.nl	Chris-Whitelist
philips.nl	Chris-Whitelist
picnic.nl	Chris-Whitelist
post.nl	Chris-Whitelist
postnl.nl	Chris-Whitelist
rabobank.nl	Chris-Whitelist, Adguard-Banks-White
reaal.nl	Chris-Whitelist
regiobank.nl	Adguard-Banks-White
santander.nl	Adguard-Banks-White
snsbank.nl	Adguard-Banks-White
staatslotterij.nl	Chris-Whitelist
triodos.nl	Adguard-Banks-White
uwzorgonline.nl	Adguard-Sensitive-White
veronicatv.nl	Chris-Whitelist
vnumediaonline.nl	Chris-Whitelist
vpro.nl	Chris-Whitelist
waternet.nl	Chris-Whitelist
xs4all.nl	Chris-Whitelist
3dsecure.no	Adguard-Banks-White
afjord-sparebank.no	Adguard-Banks-White
altinn.no	Adguard-Banks-White
andebu-sparebank.no	Adguard-Banks-White
aurskog-sparebank.no	Adguard-Banks-White
bankid.no	Adguard-Banks-White
bankidapis.no	Adguard-Banks-White
bankidnorge.no	Adguard-Banks-White
id.banknorwegian.no	Adguard-Banks-White
identity.banknorwegian.no	Adguard-Banks-White
berg-sparebank.no	Adguard-Banks-White
besoklegen.no	Adguard-Sensitive-White
bien.no	Adguard-Banks-White
birkenes-sparebank.no	Adguard-Banks-White
bjugn-sparebank.no	Adguard-Banks-White
nettbank2.danskebank.no	Adguard-Banks-White
dengulebanken.no	Adguard-Banks-White
difi.no	Adguard-Banks-White
eh-sparebank.no	Adguard-Banks-White
eika.no	Adguard-Banks-White
esbank.no	Adguard-Banks-White
etnedalsparebank.no	Adguard-Banks-White
gildeskaal-sparebank.no	Adguard-Banks-White
grong-sparebank.no	Adguard-Banks-White
gruesparebank.no	Adguard-Banks-White
haltdalensparebank.no	Adguard-Banks-White
hegrasparebank.no	Adguard-Banks-White
hemnesparebank.no	Adguard-Banks-White
hjartdalbanken.no	Adguard-Banks-White
hjelmeland-sparebank.no	Adguard-Banks-White
hsbank.no	Adguard-Banks-White
selfservice.ikano.no	Adguard-Banks-White
jaerensparebank.no	Adguard-Banks-White
jbf.no	Adguard-Banks-White
kvinesdalsparebank.no	Adguard-Banks-White
larvikbanken.no	Adguard-Banks-White
marker-sparebank.no	Adguard-Banks-White
melhusbanken.no	Adguard-Banks-White
pvu.nets.no	Adguard-Banks-White
nettbanken.nordea.no	Adguard-Banks-White
nordirekte.no	Adguard-Banks-White
oasparebank.no	Adguard-Banks-White
odal-sparebank.no	Adguard-Banks-White
oppdalsbanken.no	Adguard-Banks-White
orklasparebank.no	Adguard-Banks-White
orskogsparebank.no	Adguard-Banks-White
ose.no	UT1-Finance
oslobors.no	UT1-Finance
oslofjordsparebank.no	Adguard-Banks-White
pasientsky.no	Adguard-Banks-White
portalbank.no	Adguard-Banks-White
rindalsbanken.no	Adguard-Banks-White
romsdalsbanken.no	Adguard-Banks-White
rorosbanken.no	Adguard-Banks-White
rsbank.no	Adguard-Banks-White
id.santanderconsumer.no	Adguard-Banks-White
minnettbank.santanderconsumer.no	Adguard-Banks-White
skagerraksparebank.no	Adguard-Banks-White
skuesparebank.no	Adguard-Banks-White
sn.no	Adguard-Banks-White
sognbank.no	Adguard-Banks-White
soknedal-sparebank.no	Adguard-Banks-White
sparebank1.no	Adguard-Banks-White
strommensparebank.no	Adguard-Banks-White
sunndal-sparebank.no	Adguard-Banks-White
tinnbank.no	Adguard-Banks-White
totenbanken.no	Adguard-Banks-White
tsbank.no	Adguard-Banks-White
tysnes-sparebank.no	Adguard-Banks-White
valdressparebank.no	Adguard-Banks-White
valle-sparebank.no	Adguard-Banks-White
vekselbanken.no	Adguard-Banks-White
investor.vps.no	Adguard-Banks-White
secure.ya.no	Adguard-Banks-White
yanettbank.ya.no	Adguard-Banks-White
hostsfile.mine.nu	Chris-Whitelist
anz.co.nz	Adguard-Banks-White
asb.co.nz	Adguard-Banks-White
bnz.co.nz	Adguard-Banks-White
co-operativebank.co.nz	Adguard-Banks-White
fanboy.co.nz	Chris-Whitelist
kiwibank.co.nz	Adguard-Banks-White
rabobank.co.nz	Adguard-Banks-White
sbsbank.co.nz	Adguard-Banks-White
tsb.co.nz	Adguard-Banks-White
westpac.co.nz	Adguard-Banks-White
financialufabet.online	UT1-Finance
thefinancialfreedom.online	UT1-Finance
1stnorcalcu.org	Adguard-Banks-White
360financialliteracy.org	UT1-Finance
easylist-downloads.adblockplus.org	Chris-Whitelist
api.adguard.org	Adguard-Issues-White
adtidy.org	Chris-Whitelist
freedns.afraid.org	Chris-Whitelist
agfinancial.org	UT1-Finance
www.agranibank.org	Adguard-Banks-White
agranisme.org	Adguard-Banks-White
allegacy.org	Adguard-Banks-White
alliantcreditunion.org	Adguard-Banks-White
ampproject.org	Chris-Whitelist
antipubfirefox.org	Chris-Whitelist
arizonafinancial.org	UT1-Finance
autoshun.org	Chris-Whitelist
bcu.org	Adguard-Banks-White
becu.org	Adguard-Banks-White
bitbucket.org	Chris-Whitelist
tracker.bro.org	Chris-Whitelist
www.burobd.org	Adguard-Banks-White
cbcfcu.org	Adguard-Banks-White
centerforfinancialinclusion.org	UT1-Finance
centerforfinancialstability.org	UT1-Finance
online.cutx.org	Adguard-Banks-White
dcu.org	Adguard-Banks-White
dcu-online.org	Adguard-Banks-White
debian.org	Chris-Whitelist
download.dnscrypt.org	Chris-Whitelist
docfcu.org	Adguard-Banks-White
dshield.org	Chris-Whitelist
dsmynas.org	Adguard-Sensitive-White
familyds.org	Adguard-Sensitive-White
financial-world.org	UT1-Finance
financialcommission.org	UT1-Finance
financialcrimeacademy.org	UT1-Finance
financialdataexchange.org	UT1-Finance
financialeducatorscouncil.org	UT1-Finance
financialexecutives.org	UT1-Finance
financialinclusionnigeria.org	UT1-Finance
financialplanningassociation.org	UT1-Finance
financialservices.org	UT1-Finance
financialstabilityboard.org	UT1-Finance
financialtherapyassociation.org	UT1-Finance
financialtransparency.org	UT1-Finance
firstfinancial.org	UT1-Finance
firstfinancialadvisors.org	UT1-Finance
floridastudentfinancialaid.org	UT1-Finance
floridastudentfinancialaidsg.org	UT1-Finance
stats.foldingathome.org	MMoti
nmcheck.gnome.org	Chris-Connect
www.grameen-info.org	Adguard-Banks-White
growfinancial.org	UT1-Finance
gtefinancial.org	UT1-Finance
iana.org	Chris-Whitelist
www.idcol.org	Adguard-Banks-White
ibank2.intercredit.org	Adguard-Banks-White
api.ipify.org	AnuDeep
isc.org	Chris-Whitelist
www.jcfbd.org	Adguard-Banks-White
jumpdanceco.org	Chris-Whitelist
lede-project.org	Chris-Whitelist
lineageos.org	Chris-Whitelist
mailbox.org	Adguard-Sensitive-White
master-capital.org	Adguard-Banks-White
mctcu.org	Adguard-Banks-White
mitfcu.org	Adguard-Banks-White
msfinancialaid.org	UT1-Finance
winhelp2002.mvps.org	Chris-Whitelist
myfedloan.org	Adguard-Banks-White
myfinancialgoals.org	UT1-Finance
navyfederal.org	Adguard-Banks-White, Adguard-Sensitive-White
networksec.org	Chris-Whitelist
newfinancial.org	UT1-Finance
notabug.org	Chris-Whitelist
nothink.org	Chris-Whitelist
ntp.org	Chris-Whitelist
openstreetmap.org	Chris-Whitelist
ourfinancialsecurity.org	UT1-Finance
outlookfinancial.org	UT1-Finance
palmettohealthcu.org	Adguard-Banks-White
pelco.org	Chris-Whitelist
penfed.org	Adguard-Banks-White
powerdns.org	Chris-Whitelist
prestigecu.org	Adguard-Sensitive-White
projecthoneypot.org	Chris-Whitelist
redwoodcu.org	Adguard-Banks-White
spdy3.maps.rostaxi.org	Adguard-Android-White
sans.org	Chris-Whitelist
schema.org	Chris-Whitelist
e.sfcu.org	Adguard-Banks-White
www.sfdw.org	Adguard-Banks-White
someonewhocares.org	Chris-Whitelist
spamhaus.org	Chris-Whitelist
squidblacklist.org	Chris-Whitelist
stanev.org	Chris-Whitelist
sa-blacklist.stearns.org	Chris-Whitelist
sysctl.org	Chris-Whitelist
team-cymru.org	Chris-Whitelist
thepiratebay.org	Pi-DNS
tiaa.org	Adguard-Banks-White
check.torproject.org	Chris-Whitelist
traviscu.org	Adguard-Banks-White
trustonefinancial.org	UT1-Finance
uiccu.org	Adguard-Banks-White
umcu.org	Adguard-Banks-White
upma.org	Adguard-Banks-White
usfinancialcapability.org	UT1-Finance
veridiancu.org	Adguard-Banks-White
vystarcu.org	Adguard-Banks-White
widscambridge.org	Chris-Whitelist
yoyo.org	Chris-Whitelist
chinabank.ph	Adguard-Banks-White
asiaunited.com.ph	Adguard-Banks-White
bdo.com.ph	Adguard-Banks-White
bpi.com.ph	Adguard-Banks-White
citibank.com.ph	Adguard-Banks-White
pnb.com.ph	Adguard-Banks-White
freelancer.ph	Adguard-Sensitive-White
xsell.infra.photos	Chris-Whitelist
photobookcreate.organise.photos	Chris-Whitelist
group.pictet	Adguard-Banks-White
www.nbp.com.pk	Adguard-Banks-White
aliorbank.pl	Adguard-Banks-White
bankmillennium.pl	Adguard-Banks-White
goonline.bnpparibas.pl	Adguard-Banks-White
bosbank24.pl	Adguard-Banks-White
bph.pl	Adguard-Banks-White
login.bsczarnkow.pl	Adguard-Banks-White
cdm24.pl	Adguard-Banks-White
centrum24.pl	Adguard-Banks-White
citibankonline.pl	Adguard-Banks-White
orangefinanse.com.pl	Adguard-Banks-White
pekao.com.pl	Adguard-Banks-White
ca24.credit-agricole.pl	Adguard-Banks-White
db-pbc.pl	Adguard-Banks-White
deutschebank.pl	Adguard-Banks-White
ue.dnb.pl	Adguard-Banks-White
e25.pl	Adguard-Banks-White
secure.getinbank.pl	Adguard-Banks-White
gov.pl	Adguard-Sensitive-White
secure.ideabank.pl	Adguard-Banks-White
ing.pl	Adguard-Banks-White
ingbank.pl	Adguard-Banks-White
inteligo.pl	Adguard-Banks-White
www.ipko.pl	Adguard-Banks-White
www.ipkobiznes.pl	Adguard-Banks-White
online.mbank.pl	Adguard-Banks-White
login.nestbank.pl	Adguard-Banks-White
ekonto.paluckibs.pl	Adguard-Banks-White
pekao24.pl	Adguard-Banks-White
plusbank24.pl	Adguard-Banks-White
online.pocztowy.pl	Adguard-Banks-White
sgb24.pl	Adguard-Banks-White
t-mobilebankowe.pl	Adguard-Banks-White
keenetic.pro	Adguard-Issues-White
homebanking.bancoctt.pt	Adguard-Banks-White
big.pt	Adguard-Banks-White
caixaebankingonline.cgd.pt	Adguard-Banks-White
deutsche-bank.pt	Adguard-Banks-White
gotcha.pw	Chris-Whitelist
24banking.ro	Adguard-Banks-White
alphabank.ro	Adguard-Banks-White
bcr.ro	Adguard-Banks-White
bfer.ro	Adguard-Banks-White
onlinebanking.brci.ro	Adguard-Banks-White
brdoffice.ro	Adguard-Banks-White
brom.ro	Adguard-Banks-White
btrl.ro	Adguard-Banks-White
ceconline.ro	Adguard-Banks-White
crediteurope.ro	Adguard-Banks-White
ebank.eximbank.ro	Adguard-Banks-White
financialintelligence.ro	UT1-Finance
online.garantibbva.ro	Adguard-Banks-White
go.ro	Pi-DNS
homebank.ro	Adguard-Banks-White
i-conect.ro	Adguard-Banks-White
ibank.idea-bank.ro	Adguard-Banks-White
internetbanking.ro	Adguard-Banks-White
ib.intesasanpaolobank.ro	Adguard-Banks-White
leumi.ro	Adguard-Banks-White
mybrdnet.ro	Adguard-Banks-White
otpdirekt.ro	Adguard-Banks-White
corporate.patriabank.ro	Adguard-Banks-White
retail.patriabank.ro	Adguard-Banks-White
raiffeisenonline.ro	Adguard-Banks-White
ibank.roib.ro	Adguard-Banks-White
ibkvbr.vistabank.ro	Adguard-Banks-White
zoso.ro	Chris-Whitelist
netbanking.erstebank.rs	Adguard-Banks-White
halkbank.rs	Adguard-Banks-White
internet.1mbank.ru	Adguard-Banks-White
a-3.ru	Adguard-Banks-White
abr.ru	Adguard-Banks-White
absolutbank.ru	Adguard-Banks-White
ibank.acbank.ru	Adguard-Banks-White
pay.aeroflot.ru	Adguard-Banks-White
dbo.agroros.ru	Adguard-Banks-White
terminal.akado.ru	Adguard-Banks-White
akbars.ru	Adguard-Banks-White
bank.akbtb.ru	Adguard-Banks-White
ibank.akcia-bank.ru	Adguard-Banks-White
ibank.akibank.ru	Adguard-Banks-White
albank.ru	Adguard-Banks-White
online.alefbank.ru	Adguard-Banks-White
ibank.alexbank.ru	Adguard-Banks-White
alfabank.ru	Adguard-Banks-White
alfaportal.ru	Adguard-Banks-White
alorbank.ru	Adguard-Banks-White
alpari.ru	Adguard-Banks-White
cabinet.altbb.ru	Adguard-Banks-White
ibank.ankb.ru	Adguard-Banks-White
ibank.aorb.ru	Adguard-Banks-White
ibank.apabank.ru	Adguard-Banks-White
ib.apkbank.ru	Adguard-Banks-White
gate.ariuspay.ru	Adguard-Banks-White
ibank.arsenal.ru	Adguard-Banks-White
ibank.asbank.ru	Adguard-Banks-White
ibank.aspectbank.ru	Adguard-Banks-White
dbo.assotsiatsiyabank.ru	Adguard-Banks-White
atb-online.ru	Adguard-Banks-White
atbbank.ru	Adguard-Banks-White
secure.authority.ru	Adguard-Banks-White
autopays.ru	Adguard-Banks-White
avangard.ru	Adguard-Banks-White
avbank.ru	Adguard-Banks-White
ib.aversbank.ru	Adguard-Banks-White
online.avtogradbank.ru	Adguard-Banks-White
ibank.baikalcredobank.ru	Adguard-Banks-White
info.baikalinvestbank.ru	Adguard-Banks-White
bbclick.baltbank.ru	Adguard-Banks-White
online.baltbank.ru	Adguard-Banks-White
iclients.baltinvest.ru	Adguard-Banks-White
bancaintesa.ru	Adguard-Banks-White
webank.bank-45.ru	Adguard-Banks-White
ibank.bank-accent.ru	Adguard-Banks-White
onlinebanking.bank-credit-suisse-moscow.ru	Adguard-Banks-White
bank-direct.ru	Adguard-Banks-White
bank-enisey.ru	Adguard-Banks-White
ibank.bank-hlynov.ru	Adguard-Banks-White
dbo.bank-mscb.ru	Adguard-Banks-White
bank-on-line.ru	Adguard-Banks-White
bank-online.ru	Adguard-Banks-White
online.bankcard.ru	Adguard-Banks-White
bc.bankdolinsk.ru	Adguard-Banks-White
bankelita.ru	Adguard-Banks-White
ibank.bankermak.ru	Adguard-Banks-White
card2card.banki.ru	Adguard-Banks-White
dbo.bankkaluga.ru	Adguard-Banks-White
bankline.ru	Adguard-Banks-White
ibank.bankmaxima.ru	Adguard-Banks-White
clb.bankmtb.ru	Adguard-Banks-White
ib.banknp.ru	Adguard-Banks-White
bankofkazan.ru	Adguard-Banks-White
ibank.bankorange.ru	Adguard-Banks-White
bankrazvitie.ru	Adguard-Banks-White
ibank2.bankreserv.ru	Adguard-Banks-White
ibank.bankrmp.ru	Adguard-Banks-White
ib.bankrsi.ru	Adguard-Banks-White
bankrus.ru	Adguard-Banks-White
ibank.banksbrr.ru	Adguard-Banks-White
bc.banksmb.ru	Adguard-Banks-White
banksoyuz.ru	Adguard-Banks-White
bankuralsib.ru	Adguard-Banks-White
quick.bankvl.ru	Adguard-Banks-White
bbank.ru	Adguard-Banks-White
bbr.ru	Adguard-Banks-White
bcc-msk.ru	Adguard-Banks-White
online.bcs.ru	Adguard-Banks-White
lk.bcsb.ru	Adguard-Banks-White
oplata.beeline.ru	Adguard-Banks-White
paycard.beeline.ru	Adguard-Banks-White
ibank.belsocbank.ru	Adguard-Banks-White
bfa.ru	Adguard-Banks-White
ssl.biglion.ru	Adguard-Banks-White
lk.billing74.ru	Adguard-Sensitive-White
online.binbankcards.ru	Adguard-Banks-White
ibank.bkbank.ru	Adguard-Banks-White
online.bm.ru	Adguard-Banks-White
bnkv.ru	Adguard-Banks-White
dbo.boc.ru	Adguard-Banks-White
bspb.ru	Adguard-Banks-White
online.bta-kazan.ru	Adguard-Banks-White
ibank.buguruslan.ru	Adguard-Banks-White
bystrobank.ru	Adguard-Banks-White
rs-portal.capitalbank.ru	Adguard-Banks-White
ibank.capitalkredit.ru	Adguard-Banks-White
pay.cardstandard.ru	Adguard-Banks-White
ccb.ru	Adguard-Banks-White
ccbank.ru	Adguard-Banks-White
centrinvest.ru	Adguard-Banks-White
online.cetelem.ru	Adguard-Banks-White
ibank.cfbank.ru	Adguard-Banks-White
chelindbank.ru	Adguard-Banks-White
ib.chelinvest.ru	Adguard-Banks-White
payments.chronopay.ru	Adguard-Banks-White
ibank.cibank.ru	Adguard-Banks-White
citibank.ru	Adguard-Banks-White
orders.cloudpayments.ru	Adguard-Banks-White
cmbank.ru	Adguard-Banks-White
dbo.isbank.com.ru	Adguard-Banks-White
ibank.tpsb.com.ru	Adguard-Banks-White
money.comepay.ru	Adguard-Banks-White
bss.constans.ru	Adguard-Banks-White
ibank.credexbank.ru	Adguard-Banks-White
crediteurope.ru	Adguard-Banks-White
creditplus.ru	Adguard-Banks-White
creditural.ru	Adguard-Banks-White
card.cyberplat.ru	Adguard-Banks-White
info.cyberplat.ru	Adguard-Banks-White
dalena.ru	Adguard-Banks-White
info.deltacredit.ru	Adguard-Banks-White
dengisend.ru	Adguard-Banks-White
iclient.devoncredit.ru	Adguard-Banks-White
iclient2.devoncredit.ru	Adguard-Banks-White
iclient3.devoncredit.ru	Adguard-Banks-White
mib.devoncredit.ru	Adguard-Banks-White
ibank.dhb.ru	Adguard-Banks-White
payb2b.domru.ru	Adguard-Banks-White
ufa.wifi.domru.ru	Adguard-Issues-White
ibank.doncombank.ru	Adguard-Banks-White
ibank.dtb1.ru	Adguard-Banks-White
ibank.dvbank.ru	Adguard-Banks-White
e-life.ru	Adguard-Banks-White
dbo.eab.ru	Adguard-Banks-White
telebank.eatpbank.ru	Adguard-Banks-White
online.econombank.ru	Adguard-Banks-White
ibank.economiks.ru	Adguard-Banks-White
efactoring.ru	Adguard-Banks-White
efbank.ru	Adguard-Banks-White
ibank.eka-bank.ru	Adguard-Banks-White
ekapusta.ru	Adguard-Banks-White
ibank.elbin-bank.ru	Adguard-Banks-White
1.elecsnet.ru	Adguard-Banks-White
old1.elecsnet.ru	Adguard-Banks-White
i.emb.ru	Adguard-Banks-White
ib.energobank.ru	Adguard-Banks-White
dbo.energomashbank.ru	Adguard-Banks-White
pay.ertelecom.ru	Adguard-Banks-White
ekb.esplus.ru	Adguard-Sensitive-White
lkk-ekb.esplus.ru	Adguard-Sensitive-White
ibank2.eubank.ru	Adguard-Banks-White
eurasian-bank.ru	Adguard-Banks-White
ibank.euroalliance.ru	Adguard-Banks-White
eurocitybank.ru	Adguard-Banks-White
europlan.ru	Adguard-Banks-White
my.europlanbank.ru	Adguard-Banks-White
online.exi-bank.ru	Adguard-Banks-White
expr.ru	Adguard-Banks-White
express-bank.ru	Adguard-Banks-White
ezaimo.ru	Adguard-Banks-White
faktura.ru	Adguard-Banks-White
fastpic.ru	Chris-Whitelist
ibank.fbbank.ru	Adguard-Banks-White
fbid.ru	Adguard-Banks-White
fin-online.ru	Adguard-Banks-White
ibank.finam.ru	Adguard-Banks-White
ib.finambank.ru	Adguard-Banks-White
financial-lawyer.ru	UT1-Finance
bss.finars.ru	Adguard-Banks-White
online.fincap.ru	Adguard-Banks-White
ibank.finprombank.ru	Adguard-Banks-White
ibank.finsb.ru	Adguard-Banks-White
online.fondservice.ru	Adguard-Banks-White
forabank.ru	Adguard-Banks-White
ibank.forbank.ru	Adguard-Banks-White
telebank.forshtadt.ru	Adguard-Banks-White
ibank.forusbank.ru	Adguard-Banks-White
ibank.fpkbank.ru	Adguard-Banks-White
ibank.ftbank.ru	Adguard-Banks-White
ibank.gazbank.ru	Adguard-Banks-White
gazprombank.ru	Adguard-Banks-White
ibank.gaztransbank.ru	Adguard-Banks-White
ibank.gbm.ru	Adguard-Banks-White
ibank2.genbank.ru	Adguard-Banks-White
pay.geobank.ru	Adguard-Banks-White
ibc.gib.ru	Adguard-Banks-White
gibank.ru	Adguard-Banks-White
globexbank.ru	Adguard-Banks-White
gorod23.ru	Adguard-Banks-White
gosuslugi.ru	Adguard-Sensitive-White
zakupki.gov.ru	Adguard-Sensitive-White
online.gpb.ru	Adguard-Banks-White
greenmoney.ru	Adguard-Banks-White
ibank.grisbank.ru	Adguard-Banks-White
banking.guarantee.ru	Adguard-Banks-White
gutapay.ru	Adguard-Banks-White
handybank.ru	Adguard-Banks-White
ib.homecredit.ru	Adguard-Banks-White
life.homecredit.ru	Adguard-Banks-White
ibam24.ru	Adguard-Banks-White
ibank.ru	Adguard-Banks-White
ibank2.ru	Adguard-Banks-White
ibank.icbe.ru	Adguard-Banks-White
igsb.ru	Adguard-Banks-White
ikib.ru	Adguard-Banks-White
imoneybank.ru	Adguard-Banks-White
in-bank.ru	Adguard-Banks-White
ibank.informpb.ru	Adguard-Banks-White
dbo.inkaro.ru	Adguard-Banks-White
cb.inresbank.ru	Adguard-Banks-White
intechbank.ru	Adguard-Banks-White
intellectmoney.ru	Adguard-Banks-White
intercommerz.ru	Adguard-Banks-White
ibank2.intercredit.ru	Adguard-Banks-White
ibank.interkb.ru	Adguard-Banks-White
ibank.interprombank.ru	Adguard-Banks-White
card2card.intervale.ru	Adguard-Banks-White
bc.invb.ru	Adguard-Banks-White
clbank.investcapitalbank.ru	Adguard-Banks-White
investpay.ru	Adguard-Banks-White
ipb.ru	Adguard-Banks-White
ibank.ipoteka-tut.ru	Adguard-Banks-White
ibank.isbank.ru	Adguard-Banks-White
online.isbmsk.ru	Adguard-Banks-White
isnbank.ru	Adguard-Banks-White
client-bank.itbank.ru	Adguard-Banks-White
ivybank.ru	Adguard-Banks-White
izhcard.ru	Adguard-Banks-White
ibank.izhcombank.ru	Adguard-Banks-White
ibank.jtbank.ru	Adguard-Banks-White
www2.jugra.ru	Adguard-Banks-White
my.k-bnk.ru	Adguard-Banks-White
dbo.kamgorizont.ru	Adguard-Banks-White
dbo.kamkombank.ru	Adguard-Banks-White
online.kamkombank.ru	Adguard-Banks-White
i-bank.kb-rtb.ru	Adguard-Banks-White
rsportal.kbca.ru	Adguard-Banks-White
ibank2.kbhmb.ru	Adguard-Banks-White
ibank2.kbmil.ru	Adguard-Banks-White
bc.kbmkb.ru	Adguard-Banks-White
dbo.kbmsb.ru	Adguard-Banks-White
iclb.kbreb.ru	Adguard-Banks-White
ibank.kbsammit.ru	Adguard-Banks-White
kbtub.ru	Adguard-Banks-White
ibank.kbumb.ru	Adguard-Banks-White
ibank.khmb.ru	Adguard-Banks-White
ibank.kkapb.ru	Adguard-Banks-White
kkb.ru	Adguard-Banks-White
ib.kmbank.ru	Adguard-Banks-White
online.kombank.ru	Adguard-Banks-White
kontur-ca.ru	Adguard-Sensitive-White
kranbank.ru	Adguard-Banks-White
i.kredprombank.ru	Adguard-Banks-White
ibank.kremlinbank.ru	Adguard-Banks-White
ibankrez.kremlinbank.ru	Adguard-Banks-White
ibank2.krossinv.ru	Adguard-Banks-White
ks-bank.ru	Adguard-Banks-White
ksib.ru	Adguard-Banks-White
kubank.ru	Adguard-Banks-White
kubankredit.ru	Adguard-Banks-White
icb.kubantorgbank.ru	Adguard-Banks-White
kurskprombank.ru	Adguard-Banks-White
kuzbank.ru	Adguard-Banks-White
kuzbasshimbank.ru	Adguard-Banks-White
kvartplata.ru	Adguard-Banks-White
kykyryza.ru	Adguard-Banks-White
ibank2.lanta.ru	Adguard-Banks-White
lenta.ru	Chris-Whitelist
my.letobank.ru	Adguard-Banks-White
lgn.ru	Adguard-Banks-White
ibank.lightbank.ru	Adguard-Banks-White
lime-zaim.ru	Adguard-Banks-White
lkv02.ru	Adguard-Banks-White
i.lockobank.ru	Adguard-Banks-White
lovizaim.ru	Adguard-Banks-White
m2mbank.ru	Adguard-Banks-White
money.mail.ru	Adguard-Banks-White
mangomoney.ru	Adguard-Banks-White
ibank.mbfi.ru	Adguard-Banks-White
bc.mbr.ru	Adguard-Banks-White
ibank.mcbank.ru	Adguard-Banks-White
online.mcbankrus.ru	Adguard-Banks-White
ibank.mcombank.ru	Adguard-Banks-White
i.mdm.ru	Adguard-Banks-White
p2p.mdm.ru	Adguard-Banks-White
3ds.mdmbank.ru	Adguard-Banks-White
client.mdmbank.ru	Adguard-Banks-White
bank.megafon.ru	Adguard-Banks-White
lk.megafon.ru	Adguard-Sensitive-White
nwdealer.megafon.ru	Adguard-Sensitive-White
pay.megafon.ru	Adguard-Banks-White
upay.megafon.ru	Adguard-Banks-White
ibank.metallurgbank.ru	Adguard-Banks-White
online.metcom.ru	Adguard-Banks-White
dbo.metcombank.ru	Adguard-Banks-White
info.metib.ru	Adguard-Banks-White
dms.metlife.ru	Adguard-Issues-White
mfbank.ru	Adguard-Banks-White
ib.mfk-bank.ru	Adguard-Banks-White
ibank.mia.ru	Adguard-Banks-White
mid.ru	Adguard-Issues-White
migcredit.ru	Adguard-Banks-White
ibank.miko-bank.ru	Adguard-Banks-White
minbank.ru	Adguard-Banks-White
mirconnect.ru	Adguard-Banks-White
card2card.mkb.ru	Adguard-Banks-White
online.mkb.ru	Adguard-Banks-White
vbo.mkb.ru	Adguard-Banks-White
mmbank.ru	Adguard-Banks-White
dbo.mnhb.ru	Adguard-Banks-White
oplatatroika.mobi-money.ru	Adguard-Banks-White
bic.modulbank.ru	Adguard-Banks-White
my.modulbank.ru	Adguard-Banks-White
moneta.ru	Adguard-Banks-White
moneymail.ru	Adguard-Banks-White
moneyman.ru	Adguard-Banks-White
moscombank.ru	Adguard-Banks-White
cb.mosexibank.ru	Adguard-Banks-White
moskb.ru	Adguard-Banks-White
ibank.mosoblbank.ru	Adguard-Banks-White
wb.mosoblbank.ru	Adguard-Banks-White
lisa.motivtelecom.ru	Adguard-Sensitive-White
lk.motivtelecom.ru	Adguard-Banks-White
shpd.motivtelecom.ru	Adguard-Banks-White
mpaycard.ru	Adguard-Banks-White
ibank.mpbbank.ru	Adguard-Banks-White
ibank.mrbank.ru	Adguard-Banks-White
files.msal.ru	Adguard-Issues-White
mspbank.ru	Adguard-Banks-White
mteb.ru	Adguard-Banks-White
mtibank.ru	Adguard-Banks-White
pay.mts.ru	Adguard-Banks-White
mtsbank.ru	Adguard-Banks-White
retail.mvbank.ru	Adguard-Banks-White
ib.mvkb.ru	Adguard-Banks-White
my-zaim.ru	Adguard-Banks-White
myskb.ru	Adguard-Banks-White
nalog.ru	Adguard-Banks-White
client.nb-bank.ru	Adguard-Banks-White
nbmc.ru	Adguard-Banks-White
cardhouse.ncc-uc.ru	Adguard-Banks-White
bk17.ncubank.ru	Adguard-Banks-White
b2.ndb24.ru	Adguard-Banks-White
ibank2.ndbank.ru	Adguard-Banks-White
ibank.necklace.ru	Adguard-Banks-White
ib.nevskybank.ru	Adguard-Banks-White
ibank2.newbank.ru	Adguard-Banks-White
newstube.ru	Adguard-Android-White
ibank2.newtimebank.ru	Adguard-Banks-White
bk.nico-bank.ru	Adguard-Banks-White
nipbank.ru	Adguard-Banks-White
bclient.nkcbank.ru	Adguard-Banks-White
ibank2.nmbank.ru	Adguard-Banks-White
nokss.ru	Adguard-Banks-White
nordea.ru	Adguard-Banks-White
bss.novahovcb.ru	Adguard-Banks-White
ib.novobank.ru	Adguard-Banks-White
ibank.npbank.ru	Adguard-Banks-White
retail.nrb.ru	Adguard-Banks-White
ns-bank.ru	Adguard-Banks-White
ibank.nskbl.ru	Adguard-Banks-White
ib.nvkbank.ru	Adguard-Banks-White
ic.nw1ab.ru	Adguard-Banks-White
ibank.nwipbank.ru	Adguard-Banks-White
ibank.nz.ru	Adguard-Banks-White
ibank.spb.nz.ru	Adguard-Banks-White
oaookb.ru	Adguard-Banks-White
ibank.obrbank.ru	Adguard-Banks-White
dbo.oceanbank.ru	Adguard-Banks-White
ofc.ru	Adguard-Banks-White
ibk.ofkbank.ru	Adguard-Banks-White
tamtam.ok.ru	Adguard-Android-White
sprint.olabank.ru	Adguard-Banks-White
clb.olmabank.ru	Adguard-Banks-White
sibes.omsk.ru	Adguard-Banks-White
oneclickmoney.ru	Adguard-Banks-White
onezaim.ru	Adguard-Banks-White
open.ru	Adguard-Banks-White
openbank.ru	Adguard-Banks-White
ibc.orgbank.ru	Adguard-Banks-White
oskolbank.ru	Adguard-Banks-White
link.otkritiefc.ru	Adguard-Banks-White
otpbank.ru	Adguard-Banks-White
payanyway.ru	Adguard-Banks-White
secure.paygateway.ru	Adguard-Banks-White
payjet.ru	Adguard-Banks-White
paymaster.ru	Adguard-Banks-White
payment.ru	Adguard-Banks-White
paymentgate.ru	Adguard-Banks-White
paymo.ru	Adguard-Banks-White
payps.ru	Adguard-Banks-White
paysecure.ru	Adguard-Banks-White
secure.payu.ru	Adguard-Banks-White
avon.payupay.ru	Adguard-Banks-White
online.pchrb.ru	Adguard-Banks-White
personalbank.ru	Adguard-Banks-White
pervbank.ru	Adguard-Banks-White
my.pervobank.ru	Adguard-Banks-White
pfbank.ru	Adguard-Banks-White
pfsbank.ru	Adguard-Banks-White
pib.ru	Adguard-Banks-White
client.pik-comfort.ru	Adguard-Banks-White
ibank.pirbank.ru	Adguard-Banks-White
pkb24.ru	Adguard-Banks-White
plat.ru	Adguard-Banks-White
platezh.ru	Adguard-Banks-White
platipokarte.ru	Adguard-Banks-White
platiza.ru	Adguard-Banks-White
lk.platon.ru	Adguard-Banks-White
platron.ru	Adguard-Banks-White
playfamily.ru	Adguard-Issues-White
ibank.plus-bank.ru	Adguard-Banks-White
my.pochtabank.ru	Adguard-Banks-White
poidem.ru	Adguard-Banks-White
ibank.prbb.ru	Adguard-Banks-White
prbkbr-ibank2.ru	Adguard-Banks-White
ibank.premcred.ru	Adguard-Banks-White
ibank2.preodbank.ru	Adguard-Banks-White
primbank.ru	Adguard-Banks-White
ibank2.priobye.ru	Adguard-Banks-White
ibank.priscocb.ru	Adguard-Banks-White
privat24.ru	Adguard-Banks-White
charts.profinance.ru	Adguard-Issues-White
profitbank.ru	Adguard-Banks-White
promenergobank.ru	Adguard-Banks-White
ibank.promregion.ru	Adguard-Banks-White
lk.promtransbank.ru	Adguard-Banks-White
ib.psbank.ru	Adguard-Banks-White
pfm.psbank.ru	Adguard-Banks-White
quik.psbank.ru	Adguard-Banks-White
psbst.ru	Adguard-Banks-White
pscb.ru	Adguard-Banks-White
ibank2.pshb.ru	Adguard-Banks-White
ibank.pulsbank.ru	Adguard-Banks-White
qiwi.ru	Adguard-Banks-White
raiffeisen.ru	Adguard-Banks-White
pay.rambler.ru	Adguard-Banks-White
otkritie.rapida.ru	Adguard-Banks-White
wallet.rapida.ru	Adguard-Banks-White
rbkmoney.ru	Adguard-Banks-White
www.re-store.ru	Adguard-Mac-White
ib.rencredit.ru	Adguard-Banks-White
ibank.rentabank.ru	Adguard-Banks-White
ibank.restrust.ru	Adguard-Banks-White
client.rfabank.ru	Adguard-Banks-White
ibank.rfb.ru	Adguard-Banks-White
rficb.ru	Adguard-Banks-White
rgsbank.ru	Adguard-Banks-White
ik.rinvestbank.ru	Adguard-Banks-White
ibank.ritzbank.ru	Adguard-Banks-White
vip.ritzbank.ru	Adguard-Banks-White
cb-retail.rmb.ru	Adguard-Banks-White
ibank.rncb.ru	Adguard-Banks-White
robokassa.ru	Adguard-Banks-White
rocketbank.ru	Adguard-Banks-White
rodnayasvyaz.ru	Adguard-Banks-White
rosavto.ru	Adguard-Banks-White
getlogin.rosbank.ru	Adguard-Banks-White
ibank.rosbank.ru	Adguard-Banks-White
ibank.roscap.ru	Adguard-Banks-White
rosenergobank.ru	Adguard-Banks-White
rosevrobank.ru	Adguard-Banks-White
rosinterbank.ru	Adguard-Banks-White
rosmicrocredit.ru	Adguard-Banks-White
cyber.rostbank.ru	Adguard-Banks-White
dbo.rostbank.ru	Adguard-Banks-White
ibank2.rostfinance.ru	Adguard-Banks-White
round.ru	Adguard-Banks-White
ul.royal-bank.ru	Adguard-Banks-White
ibank2.rrb.ru	Adguard-Banks-White
ibank.rrbank.ru	Adguard-Banks-White
rsb.ru	Adguard-Banks-White
rshb.ru	Adguard-Banks-White
connect.rtb.ru	Adguard-Banks-White
dbo.rtbk.ru	Adguard-Banks-White
ibank.rtsbank.ru	Adguard-Banks-White
dbo.rublev.ru	Adguard-Banks-White
ibank.runabank.ru	Adguard-Banks-White
ruru.ru	Adguard-Banks-White
info-msk.rusfinance.ru	Adguard-Banks-White
russipoteka.ru	Adguard-Banks-White
rzd.ru	Adguard-Sensitive-White
lk.sab-ekb.ru	Adguard-Banks-White
pay.sampo.ru	Adguard-Banks-White
online.sbbank.ru	Adguard-Banks-White
sberbank.ru	Adguard-Banks-White
sberbank-ast.ru	Adguard-Banks-White
sbrf.ru	Adguard-Banks-White
retail.sdm.ru	Adguard-Banks-White
teleweb.sdmnet.ru	Adguard-Banks-White
login.sebbank.ru	Adguard-Banks-White
ibank.selkombank.ru	Adguard-Banks-White
lk.sesb.ru	Adguard-Sensitive-White
ibank.che.sevcred.ru	Adguard-Banks-White
online.sevcred.ru	Adguard-Banks-White
acs.severgazbank.ru	Adguard-Banks-White
online.severgazbank.ru	Adguard-Banks-White
bsi.sevnb.ru	Adguard-Banks-White
siab.ru	Adguard-Banks-White
sibank.ru	Adguard-Banks-White
secure.sirena-travel.ru	Adguard-Banks-White
ibank.sistemabank.ru	Adguard-Banks-White
sistemagorod.ru	Adguard-Banks-White
dbo.slavbank.ru	Adguard-Banks-White
ibank.slavcred.ru	Adguard-Banks-White
slbank.ru	Adguard-Banks-White
smartbank.ru	Adguard-Banks-White
biz.smpbank.ru	Adguard-Banks-White
smponbank.ru	Adguard-Banks-White
ais.snbank.ru	Adguard-Banks-White
dbo.snbank.ru	Adguard-Banks-White
sngb.ru	Adguard-Banks-White
ibank.socium-bank.ru	Adguard-Banks-White
ib.solidar.ru	Adguard-Banks-White
ib.solidbank.ru	Adguard-Banks-White
sovcombank.ru	Adguard-Banks-White
ibank.soyuzny.ru	Adguard-Banks-White
ib.emb.spb.ru	Adguard-Banks-White
ib.gorbank.spb.ru	Adguard-Banks-White
gorzdrav.spb.ru	Adguard-Sensitive-White
bk.tetrapolis.spb.ru	Adguard-Banks-White
ibank.viking.spb.ru	Adguard-Banks-White
ic.vitabank.spb.ru	Adguard-Banks-White
speculator-fin.ru	UT1-Finance
ibank.spiritbank.ru	Adguard-Banks-White
ibs.spurtbank.ru	Adguard-Banks-White
srbank.ru	Adguard-Banks-White
ibank.stalbank.ru	Adguard-Banks-White
ibank.star-alliance.ru	Adguard-Banks-White
ibank2.stkbank.ru	Adguard-Banks-White
ibank.strat.ru	Adguard-Banks-White
ib.svabank.ru	Adguard-Banks-White
megapay.sviaz-bank.ru	Adguard-Banks-White
online.svrbank.ru	Adguard-Banks-White
check.svyaznoy.ru	Adguard-Mac-White
www.svyaznoy.ru	Adguard-Mac-White
bank.taatta.ru	Adguard-Banks-White
old.taatta.ru	Adguard-Banks-White
tagilbank.ru	Adguard-Banks-White
tak.ru	UT1-Finance
ibank.tatsotsbank.ru	Adguard-Banks-White
telebank.tatsotsbank.ru	Adguard-Banks-White
tavrich.ru	Adguard-Banks-White
tbank.ru	Adguard-Banks-White
i.tcb.ru	Adguard-Banks-White
iclb.tcbank.ru	Adguard-Banks-White
brokers.tcsbank.ru	Adguard-Banks-White
secure.tcsbank.ru	Adguard-Banks-White
securepay.tcsbank.ru	Adguard-Banks-White
card-transfer.tele2.ru	Adguard-Banks-White
ibank.tenderbank.ru	Adguard-Banks-White
client.texbank.ru	Adguard-Banks-White
online.tfb.ru	Adguard-Banks-White
ibank.tfbank.ru	Adguard-Banks-White
ibank.thbank.ru	Adguard-Banks-White
payments.thepayup.ru	Adguard-Banks-White
online.tkbbank.ru	Adguard-Banks-White
transcredit.ru	Adguard-Banks-White
online.transstroybank.ru	Adguard-Banks-White
trust.ru	Adguard-Banks-White
account.ubank.ru	Adguard-Banks-White
ubrr.ru	Adguard-Banks-White
udengi.ru	Adguard-Banks-White
umbank.ru	Adguard-Banks-White
uniastrum.ru	Adguard-Banks-White
enter.unicredit.ru	Adguard-Banks-White
unifinbank.ru	Adguard-Banks-White
unistream.ru	Adguard-Banks-White
ic.united.ru	Adguard-Banks-White
wpay.uniteller.ru	Adguard-Banks-White
unitpay.ru	Adguard-Banks-White
mobibank.upb.ru	Adguard-Banks-White
card.uplati.ru	Adguard-Banks-White
formy.upriver.ru	Adguard-Issues-White
ibank.uralexpress.ru	Adguard-Banks-White
uralfd.ru	Adguard-Banks-White
uralprombank.ru	Adguard-Banks-White
uralsibbank.ru	Adguard-Banks-White
ibank.ussurybank.ru	Adguard-Banks-White
utb.ru	Adguard-Banks-White
vbrr.ru	Adguard-Banks-White
ibank.vegabank.ru	Adguard-Banks-White
ic.venets-bank.ru	Adguard-Banks-White
ib.vestabank.ru	Adguard-Banks-White
ibank2.vfbank.ru	Adguard-Banks-White
ibank2r.vfbank.ru	Adguard-Banks-White
vivuso.ru	Adguard-Banks-White
api-kino.vl.ru	Adguard-Android-White
ibank.vladprombank.ru	Adguard-Banks-White
vostbank.ru	Adguard-Banks-White
vp.ru	Adguard-Banks-White
client.vpb.ru	Adguard-Banks-White
vseinstrumenti.ru	Adguard-Issues-White
gate.vseplatezhi.ru	Adguard-Banks-White
ibank.vstcb.ru	Adguard-Banks-White
vtb.ru	Adguard-Banks-White
vtb24.ru	Adguard-Banks-White
vtkbank.ru	Adguard-Banks-White
ibank.vvbank.ru	Adguard-Banks-White
ibank2.vvbank-msk.ru	Adguard-Banks-White
i-bank.vyborg-bank.ru	Adguard-Banks-White
webmoney.ru	Adguard-Banks-White
bank.woori.ru	Adguard-Banks-White
id.yandex.ru	Adguard-Sensitive-White
money.yandex.ru	Adguard-Banks-White
passport.yandex.ru	Adguard-Sensitive-White
m.taxi.yandex.ru	Adguard-Android-White
trust.yandex.ru	Adguard-Banks-White
webdav.yandex.ru	Adguard-Android-White
yarbank.ru	Adguard-Banks-White
client.yarinterbank.ru	Adguard-Banks-White
ibank.ykb.ru	Adguard-Banks-White
ibank.z-bank.ru	Adguard-Banks-White
zapsibkombank.ru	Adguard-Banks-White
zarech.ru	Adguard-Banks-White
zaymer.ru	Adguard-Banks-White
bank.zenit.ru	Adguard-Banks-White
ic.zhilcredit.ru	Adguard-Banks-White
dbo.zhivagobank.ru	Adguard-Banks-White
ziraatbank.ru	Adguard-Banks-White
alfransi.com.sa	Adguard-Banks-White
anb.com.sa	UT1-Finance
saib.com.sa	Adguard-Banks-White
onlinesbi.sbi	Adguard-Banks-White
1177.se	Adguard-Sensitive-White
aboo.se	Pi-DNS
avanza.se	Adguard-Banks-White
banknorwegian.se	Adguard-Banks-White
bolagsverket.se	Adguard-Sensitive-White
christianliljeberg.se	Chris-Whitelist
danskebank.se	Adguard-Banks-White
firstcard.se	Adguard-Banks-White
forex.se	Adguard-Banks-White
forsakringskassan.se	Adguard-Banks-White
fryksdalenssparbank.se	Adguard-Banks-White
handelsbanken.se	Adguard-Banks-White
icabanken.se	Adguard-Banks-White
ikanobank.se	Adguard-Banks-White
kronofogden.se	Adguard-Sensitive-White
lansforsakringar.se	Adguard-Banks-White
minavardkontakter.se	Adguard-Banks-White
minpension.se	Adguard-Banks-White
nordea.se	Adguard-Banks-White
nordichardware.se	Pi-DNS
pensionsmyndigheten.se	Adguard-Banks-White
resursbank.se	Adguard-Banks-White
santanderconsumer.se	Adguard-Banks-White
sbab.se	Adguard-Banks-White
seb.se	Adguard-Banks-White
wfc.sebank.se	Adguard-Banks-White
skandia.se	Adguard-Banks-White
skatteverket.se	Adguard-Sensitive-White
swedbank.se	Adguard-Banks-White
volvofinans.se	Adguard-Banks-White
citibank.com.sg	Adguard-Banks-White
internet-banking.dbs.com.sg	Adguard-Banks-White
www.posb.com.sg	Adguard-Banks-White
uob.com.sg	Adguard-Banks-White
zaobao.com.sg	Chris-Whitelist
efinancialcareers.sg	UT1-Finance
brew.sh	Chris-Whitelist
whisper.sh	Adguard-Android-White
blocklist.site	Chris-Whitelist
csob.sk	Adguard-Banks-White
ib.raiffeisen.sk	Adguard-Banks-White
danger.rulez.sk	Chris-Whitelist
slsp.sk	Adguard-Banks-White
moja.tatrabanka.sk	Adguard-Banks-White
usalliancefinancial.space	UT1-Finance
xs4all.space	Chris-Whitelist
bd.statebank	Adguard-Banks-White
manimo.su	Adguard-Banks-White
secure.ucs.su	Adguard-Banks-White
terminal.ucs.su	Adguard-Banks-White
ibank2.vpb.su	Adguard-Banks-White
citibank.co.th	Adguard-Banks-White
ktb.co.th	Adguard-Banks-White
scb.co.th	Adguard-Banks-White
thanachartbank.co.th	Adguard-Banks-White
tisco.co.th	Adguard-Banks-White
uob.co.th	Adguard-Banks-White
gsb.or.th	Adguard-Banks-White
homebank.tj	Adguard-Banks-White
ibank.tj	Adguard-Banks-White
anonym.to	Chris-Whitelist
easylist.to	Chris-Whitelist
quickconnect.to	Adguard-Sensitive-White
tawk.to	AnuDeep
esube.abank.com.tr	Adguard-Banks-White
3dsecure.akbank.com.tr	Adguard-Banks-White
kurumsal.aktifbank.com.tr	Adguard-Banks-White
online.aktifbank.com.tr	Adguard-Banks-White
esube.albaraka.com.tr	Adguard-Banks-White
online.alternatifbank.com.tr	Adguard-Banks-White
hos.anadolubank.com.tr	Adguard-Banks-White
isube.anadolubank.com.tr	Adguard-Banks-White
ahesube.anadoluhayat.com.tr	Adguard-Banks-White
atbank.com.tr	Adguard-Banks-White
ekspertiz.bankasya.com.tr	Adguard-Banks-White
esube.bankasya.com.tr	Adguard-Banks-White
bankpozitif.com.tr	Adguard-Banks-White
barokart.com.tr	Adguard-Banks-White
acs.bkm.com.tr	Adguard-Banks-White
odemegecidi.bkm.com.tr	Adguard-Banks-White
esube.burgan.com.tr	Adguard-Banks-White
cepteteb.com.tr	Adguard-Banks-White
isube.emlakkatilim.com.tr	Adguard-Banks-White
internetbankaciligi.fibabanka.com.tr	Adguard-Banks-White
internetsubesi.fibabanka.com.tr	Adguard-Banks-White
finansbank.com.tr	Adguard-Banks-White
garanti.com.tr	Adguard-Banks-White
sube.garantibbva.com.tr	Adguard-Banks-White
isube.goldenglobalbank.com.tr	Adguard-Banks-White
sanalpos.halkbank.com.tr	Adguard-Banks-White
sube.halkbank.com.tr	Adguard-Banks-White
halkbankgayrimenkul.com.tr	Adguard-Banks-White
sube.halkyatirim.com.tr	Adguard-Banks-White
hsbc.com.tr	Adguard-Banks-White
teksweb.icbc.com.tr	Adguard-Banks-White
internetsubesi.ing.com.tr	Adguard-Banks-White
kurumsalinternetsubesi.ing.com.tr	Adguard-Banks-White
ingbank.com.tr	Adguard-Banks-White
isbank.com.tr	Adguard-Banks-White
isube.kuveytturk.com.tr	Adguard-Banks-White
online.odeabank.com.tr	Adguard-Banks-White
online.osmanlimenkul.com.tr	Adguard-Banks-White
sube.oyakyatirim.com.tr	Adguard-Banks-White
param.com.tr	Adguard-Banks-White
pashaonline.pashabank.com.tr	Adguard-Banks-White
passolig.com.tr	Adguard-Banks-White
yenibayi.passotaksit.com.tr	Adguard-Banks-White
bireysel.payfix.com.tr	Adguard-Banks-White
secure.payu.com.tr	Adguard-Banks-White
online.peple.com.tr	Adguard-Banks-White
sube.sekerbank.com.tr	Adguard-Banks-White
seninbankan.com.tr	Adguard-Banks-White
isube.tbank.com.tr	Adguard-Banks-White
teb.com.tr	Adguard-Banks-White
prime.tebyatirim.com.tr	Adguard-Banks-White
online.tskb.com.tr	Adguard-Banks-White
ekspertiz.turkiyefinans.com.tr	Adguard-Banks-White
internetsube.turkiyefinans.com.tr	Adguard-Banks-White
esube.turkiyehayatemeklilik.com.tr	Adguard-Banks-White
dto.vakifbank.com.tr	Adguard-Banks-White
ekspertiz.vakifbank.com.tr	Adguard-Banks-White
kariyer.vakifbank.com.tr	Adguard-Banks-White
subesiz.vakifbank.com.tr	Adguard-Banks-White
subesizbankacilik.vakifbank.com.tr	Adguard-Banks-White
isube.vakifkatilim.com.tr	Adguard-Banks-White
id.yandex.com.tr	Adguard-Sensitive-White
passport.yandex.com.tr	Adguard-Sensitive-White
yapikredi.com.tr	Adguard-Banks-White
ziraatbank.com.tr	Adguard-Banks-White
esube.ziraatkatilim.com.tr	Adguard-Banks-White
esube1.ziraatyatirim.com.tr	Adguard-Banks-White
pro.ziraatyatirim.com.tr	Adguard-Banks-White
esube.eximbank.gov.tr	Adguard-Banks-White
intvrg.gib.gov.tr	Adguard-Banks-White
ivd.gib.gov.tr	Adguard-Banks-White
ilbank.gov.tr	Adguard-Banks-White
pttbank.ptt.gov.tr	Adguard-Banks-White
titubb.titck.gov.tr	Adguard-Banks-White
turkiye.gov.tr	Adguard-Sensitive-White
app3.takasbank.web.tr	Adguard-Banks-White
france.tv	Chris-Whitelist
noexit.tv	Pi-DNS
dashboard.plex.tv	AnuDeep
o1.email.plex.tv	AnuDeep
meta.plex.tv	AnuDeep
proxy.plex.tv	AnuDeep
pubsub.plex.tv	AnuDeep
o2.sg0.plex.tv	AnuDeep
staging.plex.tv	AnuDeep
status.plex.tv	AnuDeep
tvdb2.plex.tv	AnuDeep
apt.sonarr.tv	AnuDeep
download.sonarr.tv	AnuDeep
forums.sonarr.tv	AnuDeep
services.sonarr.tv	AnuDeep
skyhook.sonarr.tv	AnuDeep
cdn.vidible.tv	AnuDeep
delivery.vidible.tv	AnuDeep
img.vidible.tv	AnuDeep
videos.vidible.tv	AnuDeep
ebank.agribank.com.tw	Adguard-Banks-White
bok.com.tw	Adguard-Banks-White
bop.com.tw	Adguard-Banks-White
bot.com.tw	Adguard-Banks-White
cathaybk.com.tw	Adguard-Banks-White
ch6c.com.tw	Adguard-Banks-White
chb.com.tw	Adguard-Banks-White
citibank.com.tw	Adguard-Banks-White
cotabank.com.tw	Adguard-Banks-White
dbs.com.tw	Adguard-Banks-White
entiebank.com.tw	Adguard-Banks-White
esunbank.com.tw	Adguard-Banks-White
eximbank.com.tw	Adguard-Banks-White
feib.com.tw	Adguard-Banks-White
firstbank.com.tw	Adguard-Banks-White
fundrich.com.tw	Adguard-Banks-White
ebank.hc3cbank.com.tw	Adguard-Banks-White
ebank.hcfcbank.com.tw	Adguard-Banks-White
hncb.com.tw	Adguard-Banks-White
hsbc.com.tw	Adguard-Banks-White
hua215.com.tw	Adguard-Banks-White
hwataibank.com.tw	Adguard-Banks-White
i-pass.com.tw	Adguard-Banks-White
jihsunbank.com.tw	Adguard-Banks-White
ebank.kfcc.com.tw	Adguard-Banks-White
kh3c.com.tw	Adguard-Banks-White
ktb.com.tw	Adguard-Banks-White
landbank.com.tw	Adguard-Banks-White
linebank.com.tw	Adguard-Banks-White
megabank.com.tw	Adguard-Banks-White
mybank.com.tw	Adguard-Banks-White
nccc.com.tw	Adguard-Banks-White
nextbank.com.tw	Adguard-Banks-White
rakuten-bank.com.tw	Adguard-Banks-White
scsb.com.tw	Adguard-Banks-White
skbank.com.tw	Adguard-Banks-White
standardchartered.com.tw	Adguard-Banks-White
sunnybank.com.tw	Adguard-Banks-White
taipeifubon.com.tw	Adguard-Banks-White
taipeistarbank.com.tw	Adguard-Banks-White
taishinbank.com.tw	Adguard-Banks-White
tbb.com.tw	Adguard-Banks-White
tcb-bank.com.tw	Adguard-Banks-White
tcbbank.com.tw	Adguard-Banks-White
tcfhc-sec.com.tw	Adguard-Banks-White
ebank.tsca.com.tw	Adguard-Banks-White
twfhcsec.com.tw	Adguard-Banks-White
twmp.com.tw	Adguard-Banks-White
ubot.com.tw	Adguard-Banks-White
yuantabank.com.tw	Adguard-Banks-White
gov.tw	Adguard-Sensitive-White
hawho.tw	Adguard-Banks-White
ba.org.tw	Adguard-Banks-White
ibank.fast.org.tw	Adguard-Banks-White
naffic.org.tw	Adguard-Banks-White
scu.org.tw	Adguard-Banks-White
twnch.org.tw	Adguard-Banks-White
richart.tw	Adguard-Banks-White
p2p.alfabank.ua	Adguard-Banks-White
pay.alfabank.ua	Adguard-Banks-White
asviobank.ua	Adguard-Banks-White
aval.ua	Adguard-Banks-White
bank34.ua	Adguard-Banks-White
bistrozaim.ua	Adguard-Banks-White
ibank.btabank.ua	Adguard-Banks-White
a24m.a-bank.com.ua	Adguard-Banks-White
abl.agrocombank.com.ua	Adguard-Banks-White
my.alfabank.com.ua	Adguard-Banks-White
apeksbank.com.ua	Adguard-Banks-White
artembank.com.ua	Adguard-Banks-White
ibank.atcib.com.ua	Adguard-Banks-White
bank.com.ua	Adguard-Banks-White
ifobs.bankcenter.com.ua	Adguard-Banks-White
banktrust.com.ua	Adguard-Banks-White
bankvostok.com.ua	Adguard-Banks-White
bisbank.com.ua	Adguard-Banks-White
ib.bmbank.com.ua	Adguard-Banks-White
cb.buc.com.ua	Adguard-Banks-White
e.clhs.com.ua	Adguard-Banks-White
my.credit-agricole.com.ua	Adguard-Banks-White
cb.credit-optima.com.ua	Adguard-Banks-White
creditup.com.ua	Adguard-Banks-White
diamantpay.com.ua	Adguard-Banks-White
ibank.fortbank.com.ua	Adguard-Banks-White
investbank.com.ua	Adguard-Banks-White
investbank2.com.ua	Adguard-Banks-White
ifobs.kredobank.com.ua	Adguard-Banks-White
kredodirect.com.ua	Adguard-Banks-White
ibank.ksgbank.com.ua	Adguard-Banks-White
oplata.lifecell.com.ua	Adguard-Banks-White
metabankonline.com.ua	Adguard-Banks-White
ibank.mistobank.com.ua	Adguard-Banks-White
monobank.com.ua	Adguard-Banks-White
otpbank.com.ua	Adguard-Banks-White
otpsmart.com.ua	Adguard-Banks-White
p2y.com.ua	Adguard-Banks-White
biznes.platinumbank.com.ua	Adguard-Banks-White
mycredit.platinumbank.com.ua	Adguard-Banks-White
portmone.com.ua	Adguard-Banks-White
procreditbank.com.ua	Adguard-Banks-White
online.ptclick.com.ua	Adguard-Banks-White
radabank.com.ua	Adguard-Banks-White
ibank.sbrf.com.ua	Adguard-Banks-White
ibank.tascombank.com.ua	Adguard-Banks-White
thepay.com.ua	Adguard-Banks-White
online.unicombank.com.ua	Adguard-Banks-White
unison24.com.ua	Adguard-Banks-White
universalbank.com.ua	Adguard-Banks-White
cb.vtb.com.ua	Adguard-Banks-White
xcitybank.com.ua	Adguard-Banks-White
webdav.yandex.com.ua	Adguard-Android-White
promo.concord.ua	Adguard-Banks-White
online.credit-agricole.ua	Adguard-Banks-White
credit365.ua	Adguard-Banks-White
cb.creditwest.ua	Adguard-Banks-White
creditdnepr.dp.ua	Adguard-Banks-White
dvbank.ua	Adguard-Banks-White
easypay.ua	Adguard-Banks-White
pay.fidobank.ua	Adguard-Banks-White
fidomarket.ua	Adguard-Banks-White
ticket.uz.gov.ua	Adguard-Banks-White
ws.grant.ua	Adguard-Banks-White
ibank2.ua	Adguard-Banks-White
avia.ideabank.ua	Adguard-Banks-White
bus.ideabank.ua	Adguard-Banks-White
train.ideabank.ua	Adguard-Banks-White
ideaonline.ua	Adguard-Banks-White
express-credit.in.ua	Adguard-Banks-White
industrialbank.ua	Adguard-Banks-White
ipay.ua	Adguard-Banks-White
cfront.alfabank.kiev.ua	Adguard-Banks-White
clhs.kiev.ua	Adguard-Banks-White
mbank.kiev.ua	Adguard-Banks-White
kontrakt.ua	Adguard-Banks-White
marfinbank.ua	Adguard-Banks-White
moneyveo.ua	Adguard-Banks-White
monobank.ua	Adguard-Banks-White
bankid.org.ua	Adguard-Banks-White
oschadbank.ua	Adguard-Banks-White
pib.ua	Adguard-Banks-White
ibank.pinbank.ua	Adguard-Banks-White
online.piraeusbank.ua	Adguard-Banks-White
pay.platimo.ua	Adguard-Banks-White
privat24.ua	Adguard-Banks-White
privatbank.ua	Adguard-Banks-White
online.pumb.ua	Adguard-Banks-White
online.rccf.ua	Adguard-Banks-White
sberbank.ua	Adguard-Banks-White
pay.smartbank.ua	Adguard-Banks-White
tas24.ua	Adguard-Banks-White
ibank.unexbank.ua	Adguard-Banks-White
secure.upc.ua	Adguard-Banks-White
online.vtb.ua	Adguard-Banks-White
id.yandex.ua	Adguard-Sensitive-White
passport.yandex.ua	Adguard-Sensitive-White
alrayanbank.co.uk	Adguard-Banks-White
aquacard.co.uk	Adguard-Banks-White
bankofscotland.co.uk	Adguard-Banks-White
barclaycard.co.uk	Adguard-Banks-White
barclays.co.uk	Adguard-Banks-White
bbc.co.uk	Chris-Whitelist
bbci.co.uk	Chris-Whitelist
chartersavingsbank.co.uk	Adguard-Banks-White
chase.co.uk	Adguard-Banks-White
co-operativebank.co.uk	Adguard-Banks-White
coventrybuildingsociety.co.uk	Adguard-Banks-White
apps.cybonline.co.uk	Adguard-Sensitive-White
signin.ebay.co.uk	Adguard-Banks-White
efinancialcareers.co.uk	UT1-Finance
financial-expert.co.uk	UT1-Finance
financial-news.co.uk	UT1-Finance
financial-tips.co.uk	UT1-Finance
financialdirector.co.uk	UT1-Finance
financialplanningtoday.co.uk	UT1-Finance
financialreporter.co.uk	UT1-Finance
freelancer.co.uk	Adguard-Sensitive-White
halifax-online.co.uk	Adguard-Banks-White
hl.co.uk	Adguard-Banks-White
hsbc.co.uk	Adguard-Banks-White
interactivebrokers.co.uk	Adguard-Banks-White
vpos.isbank.co.uk	Adguard-Banks-White
lifetimefinancialadvisers.co.uk	UT1-Finance
online.lloydsbank.co.uk	Adguard-Banks-White
secure.lloydsbank.co.uk	Adguard-Banks-White
metrobankonline.co.uk	Adguard-Banks-White
nationwide.co.uk	Adguard-Banks-White
paragonbank.co.uk	Adguard-Banks-White
retail.santander.co.uk	Adguard-Banks-White
my.sjpbank.co.uk	Adguard-Banks-White
templegatefinancial.co.uk	UT1-Finance
tsb.co.uk	Adguard-Banks-White
ybs.co.uk	Adguard-Banks-White
ziraatbank.co.uk	Adguard-Banks-White
gov.uk	Adguard-Banks-White
bbc.net.uk	Chris-Whitelist
nhs.uk	Chris-Whitelist
financial-ombudsman.org.uk	UT1-Finance
financialfraudaction.org.uk	UT1-Finance
financialplanning.org.uk	UT1-Finance
airport.us	Chris-Whitelist, Chris-Connect
consolidatedfinancial.us	UT1-Finance
emigrantfinancial.us	UT1-Finance
squidguard.mesd.k12.or.us	Chris-Whitelist
thinkdifferent.us	Chris-Whitelist, Chris-Connect
zoom.us	Chris-Whitelist, Adguard-Android-White
ibank.kdb.uz	Adguard-Banks-White
ebank.ofb.uz	Adguard-Banks-White
ibank.ravnaqbank.uz	Adguard-Banks-White
ibank.ubank.uz	Adguard-Banks-White
ziraatbank.uz	Adguard-Banks-White
rico.com.vc	Adguard-Banks-White
bancaribe.com.ve	Adguard-Banks-White
bancocaroni.com.ve	Adguard-Banks-White
bfc.com.ve	Adguard-Banks-White
efectivo.bnc.com.ve	Adguard-Banks-White
secure.bnc.com.ve	Adguard-Banks-White
delsuronline.com.ve	Adguard-Banks-White
sofinet.com.ve	Adguard-Banks-White
bidv.vn	Adguard-Banks-White
agribank.com.vn	Adguard-Banks-White
eximbank.com.vn	Adguard-Banks-White
hsbc.com.vn	Adguard-Banks-White
vietcombank.com.vn	Adguard-Banks-White
vpbank.com.vn	Adguard-Banks-White
tpb.vn	Adguard-Banks-White
vnn-res.vgcloud.vn	Adguard-Issues-White
vietinbank.vn	Adguard-Banks-White
xn--80aae3af7av6a7a.xn--p1ai	Adguard-Banks-White
absa.co.za	Adguard-Banks-White
capitecbank.co.za	Adguard-Banks-White
financialmail.co.za	UT1-Finance
fnb.co.za	Adguard-Banks-White
nedbank.co.za	Adguard-Banks-White
standardbank.co.za	Adguard-Banks-White
techfinancials.co.za	UT1-Finance
hosts.ubuntu101.co.za	Chris-Whitelist
financialgazette.co.zw	UT1-Finance
### WHITELIST ASN ###
### WHITELIST IPv4 ###
### WHITELIST IPv6 ###
### WHITELIST EOF ###
