############################################
### ACCOMPLIST GENERATED WHITELIST       ###
### Version: 1732683788                  ###
### Chris Buijs                          ###
### https://github.com/cbuijs/accomplist ###
############################################

### SAFELIST DOMAINS ###
### SAFEUNWHITELIST DOMAINS ###
### WHITELIST REGEXES ###
### WHITELIST DOMAINS ###
aainflight.com	EasyList-Cookie-White
aetv.com	EasyList-White
apkmirror.com	EasyList-White
apple.com	EasyList-White
artnet.com	EasyList-White
adv.asahi.com	EasyList-White
web.basemark.com	EasyList-White
brighteon.com	EasyList-White
cbs.com	EasyList-White
wwwimage-tve.cbsstatic.com	EasyPrivacy-White
chatgpt.com	EasyList-White
autocomplete.clearbit.com	EasyPrivacy-White
logo.clearbit.com	EasyPrivacy-White
login.csdisco.com	EasyList-Cookie-White
curiositystream.com	EasyList-White
cwtv.com	EasyList-White
deezer.com	EasyList-White
destinationamerica.com	EasyList-White
discord.com	EasyList-White
disneyplus.com	EasyList-White
ads.doordash.com	EasyList-White
dropbox.com	EasyList-White
abp.example.com	EasyList-French-White
facebook.com	EasyList-White
fastmail.com	EasyList-White
figma.com	EasyList-White
fingerprintjs.com	EasyList-White
freeplayervideo.com	EasyList-White
gelbooru.com	EasyList-White
github.com	EasyList-White
raw.githubusercontent.com	Source
gitlab.com	EasyList-White
gmail.com	EasyList-White
gogoplay5.com	EasyList-White
gomoplayer.com	EasyList-White
accounts.google.com	EasyList-White
ads.google.com	EasyList-White
calendar.google.com	EasyList-White
cloud.google.com	EasyList-White
contacts.google.com	EasyList-White
docs.google.com	EasyList-White
drive.google.com	EasyList-White
gemini.google.com	EasyList-White
mail.google.com	EasyList-White
meet.google.com	EasyList-White
myaccount.google.com	EasyList-White
photos.google.com	EasyList-White
history.com	EasyList-White
icloud.com	EasyList-White
instagram.com	EasyList-White
instapundit.com	EasyList-White
ads.listonic.com	EasyList-White
onedrive.live.com	EasyList-White
teams.live.com	EasyList-White
matlab.mathworks.com	EasyList-White
max.com	EasyList-White
dashboard.mgid.com	EasyList-White
ads.microsoft.com	EasyList-White
teams.microsoft.com	EasyList-White
ads.midwayusa.com	EasyList-White
milfzr.com	EasyList-White, EasyLisy-Adult-White
identity.mparticle.com	EasyPrivacy-White
mui.com	EasyList-White
netflix.com	EasyList-White
chart-embed.service.newrelic.com	EasyPrivacy-White
pandora.com	EasyList-White
paramountplus.com	EasyList-White
games.pch.com	EasyList-White
peacocktv.com	EasyList-White
pinterest.com	EasyList-White
publicwww.com	EasyList-White
qobuz.com	EasyList-White
receiveasms.com	EasyList-White
reddit.com	EasyList-White
ondemand.sas.com	EasyPrivacy-White
sc2casts.com	EasyList-White
schemeflood.com	EasyList-White
sciencechannel.com	EasyList-White
slack.com	EasyList-White
smallseotools.com	EasyList-White
ads.snapchat.com	EasyList-White
sonichits.com	EasyList-White
soranews24.com	EasyList-White
sourcegraph.com	EasyList-White
spanishdict.com	EasyList-White
ads.spotify.com	EasyList-White
open.spotify.com	EasyList-White
stackblitz.com	EasyList-White
succeedscene.com	EasyList-White
ads.taboola.com	EasyList-White
testufo.com	EasyList-White
thefreedictionary.com	EasyList-White
tidal.com	EasyList-White
tiktok.com	EasyList-White
tlc.com	EasyList-White
ads.twitter.com	EasyList-White
ads.vk.com	EasyList-White
adv.welaika.com	EasyList-White
whatsapp.com	EasyList-White
x.com	EasyList-White
xfreehd.com	EasyList-White, EasyLisy-Adult-White
yellowbridge.com	EasyList-White
yibada.com	EasyList-White
music.youtube.com	EasyList-White
tv.youtube.com	EasyList-White
www.youtube.com	EasyList-White
jetzt.de	EasyList-White
pinterest.de	EasyList-White
spiegel.de	EasyList-White
faculty.uml.edu	EasyList-White
pinterest.es	EasyList-White
ads.atmosphere.copernicus.eu	EasyList-White
ads.finance	EasyList-White
partners.doctolib.fr	EasyList-French-White
serrurier-menuisier-31-ad2.site-privilege.pagesjaunes.fr	EasyList-French-White
pinterest.fr	EasyList-White
adv.gg	EasyList-White
centro.co.il	EasyList-White
gaybeeg.info	EasyList-White, EasyLisy-Adult-White
dragontea.ink	EasyList-White
material.angular.io	EasyList-White
builder.io	EasyList-White
cdpn.io	EasyList-White
codepen.io	EasyList-White
codesandbox.io	EasyList-White
github.io	EasyList-White
material.io	EasyList-White
up-load.io	EasyList-White
pinterest.it	EasyList-White
pinterest.jp	EasyList-White
stream4free.live	EasyList-White
my101.me	EasyList-Cookie-White
widget.myrentacar.me	EasyPrivacy-White
proton.me	EasyList-White
cbsi.map.fastly.net	EasyPrivacy-White
jsfiddle.net	EasyList-White
ads.kazakh-zerno.net	EasyList-White
megaup.net	EasyList-White
inflight.pacwisp.net	EasyList-Cookie-White
rule34hentai.net	EasyList-White, EasyLisy-Adult-White
urlgalleries.net	EasyList-White, EasyLisy-Adult-White
oisd.nl	EasyList-White
secure.fanboy.co.nz	Source
geekzone.co.nz	EasyList-White
adblockplus.org	EasyList-White
bitbucket.org	EasyList-White
browserbench.org	EasyList-White
discretemath.org	EasyList-White
optout.networkadvertising.org	EasyList-White
web.telegram.org	EasyList-White
wikibooks.org	EasyList-White
wikidata.org	EasyList-White
wikinews.org	EasyList-White
wikipedia.org	EasyList-White
wikiquote.org	EasyList-White
wikiversity.org	EasyList-White
wiktionary.org	EasyList-White
pinterest.ph	EasyList-White
morphic.sh	EasyList-White
notion.so	EasyList-White
easylist.to	Source
nebula.tv	EasyList-White
twitch.tv	EasyList-White
ads.elevateplatform.co.uk	EasyList-White
maxstream.video	EasyList-White
instawp.xyz	EasyList-White
### WHITELIST ASN ###
### WHITELIST IPv4 ###
### WHITELIST IPv6 ###
### WHITELIST EOF ###
