############################################
### ACCOMPLIST GENERATED WHITELIST       ###
### Version: 1732688363                  ###
### Chris Buijs                          ###
### https://github.com/cbuijs/accomplist ###
############################################

### SAFELIST DOMAINS ###
### SAFEUNWHITELIST DOMAINS ###
### WHITELIST REGEXES ###
### WHITELIST DOMAINS ###
google.ac	Google-Allow
google.ad	Google-Allow
downdetector.ae	Router-WL
google.ae	Google-Allow
google.com.ag	Google-Allow
adblock.ai	Router-WL
bfore.ai	Router-WL
donut.ai	Router-WL
folivora.ai	Router-WL
netify.ai	Router-WL
slimmer.ai	Router-WL
google.al	Google-Allow
google.am	Google-Allow
takeoff.jetstre.am	Router-WL
mj.am	Router-WL
americanexpress	Router-WL
amex	Router-WL
amsterdam	Router-WL
google.co.ao	Google-Allow
brewee.app	Router-WL
curve.app	Router-WL
ipinfo.app	Router-WL
ovpay.app	Router-WL
apple	Router-WL
downdetector.com.ar	Router-WL
google.com.ar	Google-Allow
openstreetmap.com.ar	Router-WL
tripadvisor.com.ar	Router-WL
phishing.army	Router-WL
in-addr.arpa	Router-WL
ip6.arpa	Router-WL
google.as	Google-Allow
disruptive.asia	Router-WL
google.at	Google-Allow
tripadvisor.at	Router-WL
xn--allestrungen-9ib.at	Router-WL
downdetector.com.au	Router-WL
google.com.au	Google-Allow
tripadvisor.com.au	Router-WL
zoho.com.au	Router-WL
chime.aws	Router-WL
google.az	Google-Allow
google.ba	Google-Allow
allestoringen.be	Router-WL
google.be	Google-Allow
postnl.be	Router-WL
tripadvisor.be	Router-WL
youtu.be	Google-Allow
youtube.be	Google-Allow
yt.be	Google-Allow
beer	Router-WL
google.bf	Google-Allow
google.bg	Google-Allow
swap.bike	Router-WL
gamesindustry.biz	Router-WL
neustar.biz	Router-WL
neustarlocaleze.biz	Router-WL
suip.biz	Router-WL
ctrl.blog	Router-WL
github.blog	Router-WL
truecaller.blog	Router-WL
downdetector.com.br	Router-WL
tripadvisor.com.br	Router-WL
google.bs	Google-Allow
google.bt	Google-Allow
google.co.bw	Google-Allow
google.by	Google-Allow
google.com.bz	Google-Allow
openstreetmap.bzh	Router-WL
downdetector.ca	Router-WL
google.ca	Google-Allow
openstreetmap.ca	Router-WL
tripadvisor.ca	Router-WL
google.cat	Google-Allow
whatsapp.cc	Router-WL
google.cd	Google-Allow
google.cf	Google-Allow
google.cg	Google-Allow
google.ch	Google-Allow
infomaniak.ch	Router-WL
nic.ch	Router-WL
openstreetmap.ch	Router-WL
osm.ch	Router-WL
switch.ch	Router-WL
tripadvisor.ch	Router-WL
xn--allestrungen-9ib.ch	Router-WL
delta.chat	Router-WL
google.ci	Google-Allow
google.co.ck	Google-Allow
downdetector.cl	Router-WL
google.cl	Google-Allow
openstreetmap.cl	Router-WL
supr.cl	Router-WL
tripadvisor.cl	Router-WL
dhl-api.akio.cloud	Router-WL
isams.cloud	Router-WL
google.cm	Google-Allow
zoom.com.cn	Router-WL
google.cn	Google-Allow
zyxel.cn	Router-WL
cloudwaterbrew.co	Router-WL
downdetector.com.co	Router-WL
google.com.co	Google-Allow
g.co	Google-Allow
homerun.co	Router-WL
lever.co	Router-WL
umap.openstreetmap.co	Router-WL
scdn.co	Router-WL
tripadvisor.co	Router-WL
wwrk.co	Router-WL
1password.com	Router-WL
360.com	Router-WL
4sq.com	Router-WL
abacus.com	Router-WL
abb.com	Router-WL
abtasty.com	Router-WL
abuseipdb.com	Router-WL
adguard.com	Router-WL
adguard-vpn.com	Router-WL
guce.advertising.com	Router-WL
aexp.com	Router-WL
aexp-static.com	Router-WL
airbnb.com	Router-WL
alexa.com	Router-WL
coursera.s3.amazonaws.com	Router-WL
coursera-course-photos.s3.amazonaws.com	Router-WL
coursera-misc.s3.amazonaws.com	Router-WL
coursera-university-assets.s3.amazonaws.com	Router-WL
github-cloud.s3.amazonaws.com	Router-WL
tado-hc-downloads.s3-eu-west-1.amazonaws.com	Router-WL
amazonmusic.com	Router-WL
americanexpress.com	Router-WL
amexglobalbusinesstravel.com	Router-WL
api.lab.amplitude.com	Router-WL
android.com	Google-Allow
apple.com	Router-WL
apple-cloudkit.com	Router-WL
appleiphonecell.com	Router-WL
apsis1.com	Router-WL
assaabloyservices.com	Router-WL
asus.com	Router-WL
asuscomm.com	Router-WL
asuswebstorage.com	Router-WL
atos.com	Router-WL
audiolifefestival.com	Router-WL
audioscrobbler.com	Router-WL
avira.com	Router-WL
search-api-disney.bamgrid.com	Router-WL
barnerbrand.com	Router-WL
bestofosm.com	Router-WL
bfldr.com	Router-WL
binarydefense.com	Router-WL
homebrew.bintray.com	Router-WL
blogger.com	Google-Allow
bluecatnetworks.com	Router-WL
bol.com	Router-WL
booking.com	Router-WL
bookingholdings.com	Router-WL
brandfolder.com	Router-WL
bricktracks.com	Router-WL
browserleaks.com	Router-WL
bstatic.com	Router-WL
bunq.com	Router-WL
cbsistatic.com	Router-WL
cdn-apple.com	Router-WL
cdninstagram.com	Router-WL
cdnperf.com	Router-WL
cbuamsterdam.chickenkiller.com	Router-WL
chrisbuijs.com	Router-WL
chrome.com	Google-Allow
chromebook.com	Google-Allow
circleid.com	Router-WL
cisco.com	Router-WL
ciscolive.com	Router-WL
citymapper.com	Router-WL
cloudflare.com	Router-WL
cloudperf.com	Router-WL
cnet.com	Router-WL
csnoord.com	Router-WL
culturetheque.com	Router-WL
curve.com	Router-WL
deliveroo.com	Router-WL
www.github.developerdan.com	Source
dhl.com	Router-WL
digitalanarchist.com	Router-WL
digitalocean.com	Router-WL
disneyplus.com	Router-WL
dnsleak.com	Router-WL
dnsleaktest.com	Router-WL
dnsperf.com	Router-WL
dnswarden.com	Router-WL
downdetector.com	Router-WL
downdetectorapi.com	Router-WL
dpd.com	Router-WL
dpdhl.com	Router-WL
drikbeer.com	Router-WL
dslreports.com	Router-WL
dssott.com	Router-WL
e2ro.com	Router-WL
eero.com	Router-WL
eeroassets.com	Router-WL
eeroup.com	Router-WL
eeroupdate.com	Router-WL
efficientip.com	Router-WL
egnyte.com	Router-WL
exact.com	Router-WL
expertsphp.com	Router-WL
facebook.com	Router-WL
fandom.com	Router-WL
fb.com	Router-WL
fbcdn.com	Router-WL
fbsbx.com	Router-WL
detectportal.firefox.com	Router-WL
force.com	Router-WL
foursquare.com	Router-WL
francemusique.com	Router-WL
froogle.com	Google-Allow
fullstory.com	Router-WL
gaggleamp.com	Router-WL
gartner.com	Router-WL
geoplugin.com	Router-WL
getbeamer.com	Router-WL
ggpht.com	Google-Allow
github.com	Router-WL
githubapp.com	Router-WL
githubassets.com	Router-WL
githubusercontent.com	Router-WL
gitlab.com	Router-WL
glassdoor.com	Router-WL
globalization-partners.com	Router-WL
gmail.com	Google-Allow
cdn.registerdisney.go.com	Router-WL
gocoax.com	Router-WL
google.com	Google-Allow
googleapis.com	Google-Allow
googleapps.com	Google-Allow
googlearth.com	Google-Allow
googledomains.com	Google-Allow
googleearth.com	Google-Allow
googlemail.com	Google-Allow
googlemaps.com	Google-Allow
googlepagecreator.com	Google-Allow
googlescholar.com	Google-Allow
googlesciencefair.com	Google-Allow
googlesource.com	Google-Allow
googletranslate.com	Google-Allow
googleusercontent.com	Google-Allow
googlevideo.com	Google-Allow
greenwheels.com	Router-WL
gstatic.com	Google-Allow
gvt1.com	Google-Allow
gvt2.com	Google-Allow
herokuapp.com	Router-WL
hubspot.com	Router-WL
ibosscloud.com	Router-WL
icloud.com	Router-WL
ifttt.com	Router-WL
imgflip.com	Router-WL
indiegogo.com	Router-WL
infoblox.com	Router-WL
infosecurityeurope.com	Router-WL
innersloth.com	Router-WL
instagram.com	Router-WL
intercom.com	Router-WL
intercom-mail.com	Router-WL
intercomassets.com	Router-WL
intercomcdn.com	Router-WL
ip-api.com	Router-WL
ip2location.com	Router-WL
ipdeny.com	Router-WL
ipv6-test.com	Router-WL
ipvoid.com	Router-WL
isobar.com	Router-WL
iwgplc.com	Router-WL
joinhorizons.com	Router-WL
justworks.com	Router-WL
kickstarter.com	Router-WL
klclick.com	Router-WL
komiko.com	Router-WL
kosmoseducation.com	Router-WL
kpn.com	Router-WL
lastpass.com	Router-WL
lattice.com	Router-WL
licdn.com	Router-WL
linkedin.com	Router-WL
list-manage.com	Router-WL
teams.live.com	Router-WL
logmeininc.com	Router-WL
lync.com	Router-WL
maisonsdumonde.com	Router-WL
managebac.com	Router-WL
maxmind.com	Router-WL
tripadvisor.mediaroom.com	Router-WL
messagebird.com	Router-WL
meteoplaza.com	Router-WL
data.microsoft.com	Router-WL
get.microsoft.com	Router-WL
ipv6.microsoft.com	Router-WL
manage.microsoft.com	Router-WL
teams.microsoft.com	Router-WL
update.microsoft.com	Router-WL
microsoftonline.com	Router-WL
mikrotik.com	Router-WL
mimecast.com	Router-WL
minecraftservices.com	Router-WL
mobvoi.com	Router-WL
mojang.com	Router-WL
msftconnecttest.com	Router-WL
msftncsi.com	Router-WL
msgamestudios.com	Router-WL
muscache.com	Router-WL
myregus.com	Router-WL
myshopify.com	Router-WL
myspacesworks.com	Router-WL
mzstatic.com	Router-WL
navan.com	Router-WL
nessy.com	Router-WL
netflix.com	Router-WL
nextdoor.com	Router-WL
nflxext.com	Router-WL
nflximg.com	Router-WL
nordcdn.com	Router-WL
nordvpn.com	Router-WL
ns1.com	Router-WL
nxnsattack.com	Router-WL
teams.office.com	Router-WL
ogone.com	Router-WL
disney-portal.my.onetrust.com	Router-WL
openmptcprouter.com	Router-WL
opera.com	Router-WL
pandora.com	Router-WL
panoramio.com	Google-Allow
parkmobile.com	Router-WL
paypal.com	Router-WL
paypalinc.com	Router-WL
paypalobjects.com	Router-WL
pehub.com	Router-WL
phenompeople.com	Router-WL
phonearena.com	Router-WL
podtrac.com	Router-WL
productplan.com	Router-WL
qualtrics.com	Router-WL
quora.com	Router-WL
radiofrancepub.com	Router-WL
radioparadise.com	Router-WL
radiotime.com	Router-WL
rankranger.com	Router-WL
rbxcdn.com	Router-WL
reddit.com	Router-WL
redditmedia.com	Router-WL
redditstatic.com	Router-WL
regus.com	Router-WL
rethinkdns.com	Router-WL
roblox.com	Router-WL
roocdn.com	Router-WL
rt.com	Router-WL
ifttt-dataplane.rudderstack.com	Router-WL
s-bol.com	Router-WL
salesforce.com	Router-WL
samknows-cdn.com	Router-WL
sanomamdc.com	Router-WL
sawcl.com	Router-WL
sc-static.com	Router-WL
sfbassets.com	Router-WL
sharepoint.com	Router-WL
shipmondo.com	Router-WL
shopify.com	Router-WL
shopifycdn.com	Router-WL
shopifysvc.com	Router-WL
similarweb.com	Router-WL
simplydhl.com	Router-WL
teams.skype.com	Router-WL
skypeforbusiness.com	Router-WL
skyshowtime.com	Router-WL
slack.com	Router-WL
slack-core.com	Router-WL
slack-edge.com	Router-WL
slack-files.com	Router-WL
slack-imgs.com	Router-WL
slack-msgs.com	Router-WL
slack-redir.com	Router-WL
slackb.com	Router-WL
slackdemo.com	Router-WL
slackhq.com	Router-WL
smartsheet.com	Router-WL
sonos.com	Router-WL
sophos.com	Router-WL
sophosupd.com	Router-WL
spacesworks.com	Router-WL
spinfiteartip.com	Router-WL
spotify.com	Router-WL
spotilocal.com	Router-WL
squarespace.com	Router-WL
squarespace-cdn.com	Router-WL
starlink.com	Router-WL
starlinkversions.com	Router-WL
stellarequipment.com	Router-WL
streamtheworld.com	Router-WL
stridekick.com	Router-WL
stripe.com	Router-WL
supercell.com	Router-WL
swapfiets.com	Router-WL
swarmapp.com	Router-WL
symcb.com	Router-WL
symcd.com	Router-WL
synology.com	Router-WL
tacdn.com	Router-WL
tado.com	Router-WL
test-ipv6.com	Router-WL
testcategory.com	Router-WL
themagicsauce.com	Router-WL
thermofisher.com	Router-WL
theverge.com	Router-WL
thingelstad.com	Router-WL
ticstore.com	Router-WL
ticwear.com	Router-WL
timberland.com	Router-WL
tldrnewsletter.com	Router-WL
transferwise.com	Router-WL
tripactions.com	Router-WL
tripadvisor.com	Router-WL
tripadvisorsupport.com	Router-WL
truecaller.com	Router-WL
tunein.com	Router-WL
ubnt.com	Router-WL
connectivity-check.ubuntu.com	Router-WL
ui.com	Router-WL
ultradns.com	Router-WL
unpkg.com	Router-WL
untappd.com	Router-WL
urbee.com	Router-WL
vattenfall.com	Router-WL
vimeo.com	Router-WL
vimeocdn.com	Router-WL
voxel-firmware.com	Router-WL
waze.com	Google-Allow
wbx2.com	Router-WL
weather.com	Router-WL
webex.com	Router-WL
webflow.com	Router-WL
website-files.com	Router-WL
wework.com	Router-WL
whatsapp.com	Router-WL
whatsappbrand.com	Router-WL
whoisds.com	Router-WL
windowsupdate.com	Router-WL
wistia.com	Router-WL
csp.withgoogle.com	Google-Allow
worldpay.com	Router-WL
wtfismyip.com	Router-WL
wyze.com	Router-WL
wyzecam.com	Router-WL
wzrkt.com	Router-WL
xlcdn.com	Router-WL
youtube.com	Google-Allow
youtube-nocookie.com	Google-Allow
youtubeeducation.com	Google-Allow
youtubegaming.com	Google-Allow
youtubekids.com	Google-Allow
ytimg.com	Google-Allow
zdassets.com	Router-WL
zendesk.com	Router-WL
zhmail.com	Router-WL
zoho.com	Router-WL
zohocdn.com	Router-WL
zohopublic.com	Router-WL
zohosalesiq.com	Router-WL
zohostatic.com	Router-WL
zohowebstatic.com	Router-WL
zoom.com	Router-WL
zytrax.com	Router-WL
coursera.community	Router-WL
github.community	Router-WL
soolutions.company	Router-WL
419.consulting	Router-WL
dcs.cool	Router-WL
google.co.cr	Google-Allow
google.com.cu	Google-Allow
google.cv	Google-Allow
google.com.cy	Google-Allow
downdetector.cz	Router-WL
google.cz	Google-Allow
knot-dns.cz	Router-WL
knot-resolver.cz	Router-WL
nic.cz	Router-WL
openstreetmap.cz	Router-WL
turris.cz	Router-WL
geofabrik.de	Router-WL
google.de	Google-Allow
nextdoor.de	Router-WL
openstreetmap.de	Router-WL
openstreetrouting.de	Router-WL
tripadvisor.de	Router-WL
uni-due.de	Router-WL
xn--allestrungen-9ib.de	Router-WL
youtube.de	Google-Allow
hblock.molinero.dev	Router-WL
dhl	Router-WL
google.dj	Google-Allow
downdetector.dk	Router-WL
google.dk	Google-Allow
openstreetmap.dk	Router-WL
tripadvisor.dk	Router-WL
google.dm	Google-Allow
google.com.do	Google-Allow
sli.do	Router-WL
donuts.domains	Router-WL
samuel.domains	Router-WL
superwrt.download	Router-WL
google.dz	Google-Allow
google.com.ec	Google-Allow
downdetector.ec	Router-WL
google.ee	Google-Allow
google.com.eg	Google-Allow
tripadvisor.com.eg	Router-WL
buttondown.email	Router-WL
downdetector.es	Router-WL
google.es	Google-Allow
openstreetmap.es	Router-WL
tripadvisor.es	Router-WL
google.com.et	Google-Allow
allego.eu	Router-WL
arcadebelts.eu	Router-WL
openstreetmap.eu	Router-WL
trixbrix.eu	Router-WL
weeklyosm.eu	Router-WL
zoho.eu	Router-WL
downdetector.fi	Router-WL
google.fi	Google-Allow
google.com.fj	Google-Allow
google.fm	Google-Allow
zeno.fm	Router-WL
audiolifefestival.fr	Router-WL
axa.fr	Router-WL
cultureprime.fr	Router-WL
dhl.fr	Router-WL
downdetector.fr	Router-WL
cdn.dvmr.fr	Router-WL
fip.fr	Router-WL
fipradio.fr	Router-WL
france-musique.fr	Router-WL
francebleu.fr	Router-WL
franceculture.fr	Router-WL
franceinter.fr	Router-WL
francemusique.fr	Router-WL
google.fr	Google-Allow
leboncoin.fr	Router-WL
lemouv.fr	Router-WL
maisondelaradio.fr	Router-WL
mouv.fr	Router-WL
radiofrance.fr	Router-WL
radiofrancepublicite.fr	Router-WL
tripadvisor.fr	Router-WL
youtube.fr	Google-Allow
asmodee.fun	Router-WL
better.fyi	Router-WL
google.ga	Google-Allow
google.ge	Google-Allow
google.gg	Google-Allow
google.com.gh	Google-Allow
google.com.gi	Google-Allow
goo.gl	Google-Allow
google.gl	Google-Allow
google.gm	Google-Allow
ocsp.pki.goog	Google-Allow
telephony.goog	Google-Allow
dns.google	Google-Allow
domains.google	Google-Allow
safety.google	Google-Allow
google.gp	Google-Allow
tripadvisor.com.gr	Router-WL
downdetector.gr	Router-WL
google.gr	Google-Allow
google.com.gt	Google-Allow
crontab.guru	Router-WL
matthias.guru	Router-WL
google.gy	Google-Allow
openstreetmap.hamburg	Router-WL
osm.hamburg	Router-WL
coursera.help	Router-WL
intercom.help	Router-WL
google.com.hk	Google-Allow
tripadvisor.com.hk	Router-WL
downdetector.hk	Router-WL
google.hn	Google-Allow
downdetector.hr	Router-WL
google.hr	Google-Allow
google.ht	Google-Allow
downdetector.hu	Router-WL
google.hu	Google-Allow
openstreetmap.hu	Router-WL
google.co.id	Google-Allow
tripadvisor.co.id	Router-WL
downdetector.id	Router-WL
we.id	Router-WL
downdetector.ie	Router-WL
google.ie	Google-Allow
openstreetmap.ie	Router-WL
tripadvisor.ie	Router-WL
google.co.il	Google-Allow
tripadvisor.co.il	Router-WL
google.im	Google-Allow
behired.in	Router-WL
google.co.in	Google-Allow
downdetector.in	Router-WL
lnkd.in	Router-WL
openstreetmap.in	Router-WL
tripadvisor.in	Router-WL
zoho.in	Router-WL
boink.info	Router-WL
boxmatrix.info	Router-WL
dnscrypt.info	Router-WL
dnsrpz.info	Router-WL
hardware.info	Router-WL
ibook.info	Router-WL
infocovidspain.info	Router-WL
itools.info	Router-WL
mihi.info	Router-WL
openstreetmap.info	Router-WL
pcengines.info	Router-WL
spain.info	Router-WL
whatsapp.info	Router-WL
whatsapp-plus.info	Router-WL
binaryedge.io	Router-WL
brandfolder.io	Router-WL
coredns.io	Router-WL
draw.io	Router-WL
stream.gal.io	Router-WL
getnetbox.io	Router-WL
ghcr.io	Router-WL
github.io	Router-WL
goldcast.io	Router-WL
greenhouse.io	Router-WL
intercom.io	Router-WL
ipinfo.io	Router-WL
nextdns.io	Router-WL
openstreetmap.io	Router-WL
owm.io	Router-WL
zohotagmanager.cdn.pagesense.io	Router-WL
pendo.io	Router-WL
polyfill.io	Router-WL
rebble.io	Router-WL
saplingapp.io	Router-WL
statuspage.io	Router-WL
veed.io	Router-WL
google.iq	Google-Allow
cryptostorm.is	Router-WL
google.is	Google-Allow
downdetector.it	Router-WL
google.it	Google-Allow
umap.nordai.it	Router-WL
redd.it	Router-WL
tripadvisor.it	Router-WL
google.je	Google-Allow
google.com.jm	Google-Allow
google.jo	Google-Allow
startup.jobs	Router-WL
disneyplus.disney.co.jp	Router-WL
google.co.jp	Google-Allow
downdetector.jp	Router-WL
member.ipmu.jp	Router-WL
tripadvisor.jp	Router-WL
zoho.jp	Router-WL
google.co.ke	Google-Allow
google.kg	Google-Allow
google.com.kh	Google-Allow
google.ki	Google-Allow
google.co.kr	Google-Allow
tripadvisor.co.kr	Router-WL
google.com.kw	Google-Allow
google.kz	Google-Allow
google.la	Google-Allow
openstreetmap.la	Router-WL
google.com.lb	Google-Allow
google.li	Google-Allow
reddit.app.link	Router-WL
ingka.page.link	Router-WL
mestravaux.page.link	Router-WL
google.lk	Google-Allow
google.co.ls	Google-Allow
google.lt	Google-Allow
google.lu	Google-Allow
google.lv	Google-Allow
mt.lv	Router-WL
buff.ly	Router-WL
google.com.ly	Google-Allow
google.co.ma	Google-Allow
openstreetmap.ma	Router-WL
google.md	Google-Allow
bunq.me	Router-WL
cvent.me	Router-WL
fb.me	Router-WL
google.me	Google-Allow
myparcel.me	Router-WL
revolut.me	Router-WL
seesaw.me	Router-WL
shindig.me	Router-WL
superpowered.me	Router-WL
t.me	Router-WL
telegram.me	Router-WL
tikkie.me	Router-WL
twrp.me	Router-WL
wa.me	Router-WL
whatsapp-plus.me	Router-WL
morebeer.media	Router-WL
tel.meet	Google-Allow
google.mg	Google-Allow
google.mk	Google-Allow
google.ml	Google-Allow
google.com.mm	Google-Allow
google.mn	Google-Allow
google.ms	Google-Allow
google.com.mt	Google-Allow
google.mu	Google-Allow
google.mv	Google-Allow
google.mw	Google-Allow
google.com.mx	Google-Allow
tripadvisor.com.mx	Router-WL
downdetector.mx	Router-WL
google.com.my	Google-Allow
tripadvisor.com.my	Router-WL
downdetector.my	Router-WL
google.co.mz	Google-Allow
google.com.na	Google-Allow
groepsaccommodatie.name	Router-WL
google.ne	Google-Allow
sonos.com.edgekey.net.globalredir.akadns.net	Router-WL
fbcdn-profile-a.akamaihd.net	Router-WL
instagramstatic-a.akamaihd.net	Router-WL
audio-ak-spotify-com.akamaized.net	Router-WL
alekberg.net	Router-WL
atos.net	Router-WL
disneyplus.bn5x.net	Router-WL
bunny.net	Router-WL
cdx.cedexis.net	Router-WL
d15cw65ipctsrr.cloudfront.net	Router-WL
d1hpa2gdx2lr6r.cloudfront.net	Router-WL
d2bw9i7j0tur6h.cloudfront.net	Router-WL
d2j5ihb19pt1hq.cloudfront.net	Router-WL
d33wubrfki0l68.cloudfront.net	Router-WL
d3njjcbhbojbot.cloudfront.net	Router-WL
cloudfunctions.net	Router-WL
connman.net	Router-WL
ctfassets.net	Router-WL
deliveroo.net	Router-WL
diagrams.net	Router-WL
disney-plus.net	Router-WL
dns-oarc.net	Router-WL
docusign.net	Router-WL
dslr.net	Router-WL
edgefonts.net	Router-WL
facebook.com.edgekey.net	Router-WL
sonos.com.edgekey.net	Router-WL
spotify.edgekey.net	Router-WL
facebook.com.edgesuite.net	Router-WL
msftncsi.com.edgesuite.net	Router-WL
instagramstatic-a.akamaihd.net.edgesuite.net	Router-WL
enjen.net	Router-WL
facebook.net	Router-WL
reddit.map.fastly.net	Router-WL
slack.global.ssl.fastly.net	Router-WL
fbcdn.net	Router-WL
fast.fonts.net	Router-WL
dssott.com.c.footprint.net	Router-WL
geoplugin.net	Router-WL
google.net	Google-Allow
googlezip.net	Google-Allow
hsappstatic.net	Router-WL
hwcdn.net	Router-WL
internic.net	Router-WL
cdn.jsdelivr.net	Router-WL
cdn.live.net	Router-WL
minecraft.net	Router-WL
minecraft-services.net	Router-WL
netflix.net	Router-WL
nflximg.net	Router-WL
nflxso.net	Router-WL
nflxvideo.net	Router-WL
nsone.net	Router-WL
cdn.office.net	Router-WL
teams.office.net	Router-WL
fbsbx.com.online-metrix.net	Router-WL
perfops.net	Router-WL
pi-hole.net	Router-WL
pihole.net	Router-WL
radiofrance-podcast.net	Router-WL
recaptcha.net	Router-WL, Google-Allow
ripe.net	Router-WL
root-servers.net	Router-WL
sendgrid.net	Router-WL
shouldianswer.net	Router-WL
skolengo.net	Router-WL
slack-redir.net	Router-WL
smartlauncher.net	Router-WL
sophosupd.net	Router-WL
sophosxl.net	Router-WL
speedguide.net	Router-WL
teams-msedge.net	Router-WL
tfbnw.net	Router-WL
triple-at5-be-prod.trafficmanager.net	Router-WL
triumphrat.net	Router-WL
v-cdn.net	Router-WL
videodelivery.net	Router-WL
whatsapp.net	Router-WL
whatsapp-plus.net	Router-WL
kindplannerstorage.blob.core.windows.net	Router-WL
wistia.net	Router-WL
xtracloud.net	Router-WL
neustar	Router-WL
apple.news	Router-WL
google.com.nf	Google-Allow
google.com.ng	Google-Allow
google.com.ni	Google-Allow
binaryedge.ninja	Router-WL
crawler.ninja	Router-WL
9292.nl	Router-WL
ad.nl	Router-WL
afamsterdam.nl	Router-WL
allestoringen.nl	Router-WL
amsterdam.nl	Router-WL
arrow.nl	Router-WL
asr.nl	Router-WL
at5.nl	Router-WL
belastingdienst.nl	Router-WL
brewboysbar.nl	Router-WL
bunq.nl	Router-WL
cisco.nl	Router-WL
coolblue.nl	Router-WL
deliveroo.nl	Router-WL
dhl.nl	Router-WL
dhlexpress.nl	Router-WL
dhlparcel.nl	Router-WL
digid.nl	Router-WL
dirextion.nl	Router-WL
myprivacy.dpgmedia.nl	Router-WL
finqus.nl	Router-WL
assets.fstatic.nl	Router-WL
funda.nl	Router-WL
glassdoor.nl	Router-WL
google.nl	Google-Allow
greenwheels.nl	Router-WL
hrensalarisgemak.nl	Router-WL
internet.nl	Router-WL
ipv6-test.nl	Router-WL
kindplanner.nl	Router-WL
kommago.nl	Router-WL
kpn.nl	Router-WL
leemandoner.nl	Router-WL
mijndpdpakket.nl	Router-WL
mijnoverheid.nl	Router-WL
nederlandseloterij.nl	Router-WL
nextdoor.nl	Router-WL
nlnetlabs.nl	Router-WL
nos.nl	Router-WL
npohosting.nl	Router-WL
npostart.nl	Router-WL
nt2plus.nl	Router-WL
nu.nl	Router-WL
nuon.nl	Router-WL
ohmyguts.nl	Router-WL
omroep.nl	Router-WL
openstreetmap.nl	Router-WL
ovpay.nl	Router-WL
parkmobile.nl	Router-WL
parool.nl	Router-WL
paypal.nl	Router-WL
plts.nl	Router-WL
postnl.nl	Router-WL
rabobank.nl	Router-WL
routershop.nl	Router-WL
security.nl	Router-WL
staatslotterij.nl	Router-WL
swapfiets.nl	Router-WL
test-ipv6.nl	Router-WL
timberland.nl	Router-WL
tripadvisor.nl	Router-WL
urbee.nl	Router-WL
vattenfall.nl	Router-WL
waternet.nl	Router-WL
werkenbijdenos.nl	Router-WL
xs4all.nl	Router-WL
youtube.nl	Google-Allow
zorgmail.nl	Router-WL
zuidas.nl	Router-WL
downdetector.no	Router-WL
google.no	Google-Allow
openstreetmap.no	Router-WL
google.com.np	Google-Allow
google.nr	Google-Allow
google.nu	Google-Allow
downdetector.co.nz	Router-WL
google.co.nz	Google-Allow
tripadvisor.co.nz	Router-WL
google.com.om	Google-Allow
adguard-vpn.online	Router-WL
amongusplay.online	Router-WL
dotmagazine.online	Router-WL
3gppnetwork.org	Google-Allow
adblockplus.org	Router-WL
alpinelinux.org	Router-WL
ampproject.org	Google-Allow
bestofosm.org	Router-WL
browserleaks.org	Router-WL
chromium.org	Google-Allow
cidr-report.org	Router-WL
cipherdyne.org	Router-WL
coursera.org	Router-WL
dc502wrt.org	Router-WL
network-test.debian.org	Router-WL
dnssec-tools.org	Router-WL
dshield.org	Router-WL
exodus-privacy.eu.org	Router-WL
firehol.org	Router-WL
nmcheck.gnome.org	Router-WL
google.org	Google-Allow
iana.org	Router-WL
icann.org	Router-WL
ietf.org	Router-WL
learnosm.org	Router-WL
lencr.org	Router-WL
lichess.org	Router-WL
mapaslivres.org	Router-WL
maposmatic.org	Router-WL
mappa-mercia.org	Router-WL
mediawiki.org	Router-WL
winhelp2002.mvps.org	Source
netfilter.org	Router-WL
pod.npr.org	Router-WL
pool.ntp.org	Router-WL
openbl.org	Router-WL
openbusmap.org	Router-WL
openlinkmap.org	Router-WL
openmtbmap.org	Router-WL
openrailwaymap.org	Router-WL
openseamap.org	Router-WL
openskimap.org	Router-WL
opensnowmap.org	Router-WL
openstreetbugs.org	Router-WL
openstreetmap.org	Router-WL
openstreetmapguinee.org	Router-WL
openstreetrouting.org	Router-WL
openweathermap.org	Router-WL
openwrt.org	Router-WL
osm.org	Router-WL
osmargentina.org	Router-WL
osmfoundation.org	Router-WL
osmfr.org	Router-WL
pqrs.org	Router-WL
proxycast.org	Router-WL
raspberrypi.org	Router-WL
rfc-editor.org	Router-WL
rtalabel.org	Router-WL
signal.org	Router-WL
someonewhocares.org	Source
spamhaus.org	Router-WL
switch2osm.org	Router-WL
telegram.org	Router-WL
videolan.org	Router-WL
whatsapp.org	Router-WL
whispersystems.org	Router-WL
pgl.yoyo.org	Source
google.com.pa	Google-Allow
g.page	Router-WL
google.com.pe	Google-Allow
tripadvisor.com.pe	Router-WL
downdetector.pe	Router-WL
google.com.pg	Google-Allow
google.com.ph	Google-Allow
tripadvisor.com.ph	Router-WL
downdetector.ph	Router-WL
wol.ph	Router-WL
google.com.pk	Google-Allow
downdetector.pk	Router-WL
downdetector.pl	Router-WL
google.pl	Google-Allow
openstreetmap.pl	Router-WL
syslink.pl	Router-WL
youtube.pl	Google-Allow
google.pn	Google-Allow
google.com.pr	Google-Allow
chessup.pro	Router-WL
energized.pro	Router-WL
google.ps	Google-Allow
downdetector.pt	Router-WL
google.pt	Google-Allow
tripadvisor.pt	Router-WL
sadlers-cat.pub	Router-WL
google.com.py	Google-Allow
google.com.qa	Google-Allow
sonos.radio	Router-WL
downdetector.ro	Router-WL
google.ro	Google-Allow
google.rs	Google-Allow
rustup.rs	Router-WL
downdetector.ru	Router-WL
google.ru	Google-Allow
openstreetmap.ru	Router-WL
tripadvisor.ru	Router-WL
google.rw	Google-Allow
google.com.sa	Google-Allow
google.com.sb	Google-Allow
google.sc	Google-Allow
downdetector.se	Router-WL
google.se	Google-Allow
grnh.se	Router-WL
teklager.se	Router-WL
tripadvisor.se	Router-WL
nixnet.services	Router-WL
google.com.sg	Google-Allow
tripadvisor.com.sg	Router-WL
downdetector.sg	Router-WL
brew.sh	Router-WL
google.sh	Google-Allow
nvm.sh	Router-WL
hack53.shop	Router-WL
routers.shop	Router-WL
google.si	Google-Allow
openstreetmap.si	Router-WL
downdetector.sk	Router-WL
google.sk	Google-Allow
google.com.sl	Google-Allow
google.sm	Google-Allow
google.sn	Google-Allow
google.so	Google-Allow
satellitemap.space	Router-WL
starlinkstatus.space	Router-WL
google.sr	Google-Allow
google.st	Google-Allow
stream.streamgenial.stream	Router-WL
google.com.sv	Google-Allow
starlink.sx	Router-WL
mirror.kumi.systems	Router-WL
google.td	Google-Allow
neodev.team	Router-WL
google.tg	Google-Allow
google.co.th	Google-Allow
google.com.tj	Google-Allow
google.tk	Google-Allow
google.tl	Google-Allow
google.tm	Google-Allow
google.tn	Google-Allow
easylist.to	Router-WL
google.to	Google-Allow
orwell1984.today	Router-WL
tripadvisor.com.tr	Router-WL
downdetector.web.tr	Router-WL
google.tt	Google-Allow
ift.tt	Router-WL
whatsapp.tv	Router-WL
google.com.tw	Google-Allow
tripadvisor.com.tw	Router-WL
openstreetmap.tw	Router-WL
google.co.tz	Google-Allow
google.com.ua	Google-Allow
google.co.ug	Google-Allow
downdetector.co.uk	Router-WL
scholar.google.co.uk	Google-Allow
nextdoor.co.uk	Router-WL
openstreetmap.co.uk	Router-WL
tripadvisor.co.uk	Router-WL
youtube.co.uk	Google-Allow
gov.uk	Router-WL
openstreetmap.me.uk	Router-WL
openstreetmap.org.uk	Router-WL
airport.us	Router-WL
among.us	Router-WL
bj13.us	Router-WL
teams.microsoft.us	Router-WL
p-cdn.us	Router-WL
thinkdifferent.us	Router-WL
zoom.us	Router-WL
google.com.uy	Google-Allow
google.co.uz	Google-Allow
google.com.vc	Google-Allow
google.co.ve	Google-Allow
tripadvisor.com.ve	Router-WL
google.vg	Google-Allow
google.co.vi	Google-Allow
google.com.vn	Google-Allow
tripadvisor.com.vn	Router-WL
euro.vote	Router-WL
google.vu	Google-Allow
dns.watch	Router-WL
oneweb.world	Router-WL
google.ws	Google-Allow
cloud-native-sre.wtf	Router-WL
clearurls.xyz	Router-WL
itgala.xyz	Router-WL
nixnet.xyz	Router-WL
youtube	Google-Allow
downdetector.co.za	Router-WL
google.co.za	Google-Allow
tripadvisor.co.za	Router-WL
openstreetmap.org.za	Router-WL
osm.org.za	Router-WL
google.co.zm	Google-Allow
google.co.zw	Google-Allow
### WHITELIST ASN ###
### WHITELIST IPv4 ###
### WHITELIST IPv6 ###
### WHITELIST EOF ###
