############################################
### ACCOMPLIST GENERATED BLACKLIST       ###
### Version: 1732684121                  ###
### Chris Buijs                          ###
### https://github.com/cbuijs/accomplist ###
############################################

### SAFELIST DOMAINS ###
aaaa!	Safelist-Chris-Abuse-TLDS
abb!	Safelist-Chris-Abuse-TLDS
abbott!	Safelist-Chris-Abuse-TLDS
abc!	Safelist-Chris-Abuse-TLDS
abogado!	Safelist-Chris-Abuse-TLDS
abudhabi!	Safelist-Chris-Abuse-TLDS, Safelist-Chris-Suspicious-TLDS
ac!	Safelist-Chris-Abuse-TLDS
academy!	Safelist-Chris-Abuse-TLDS, Safelist-Chris-Suspicious-TLDS, Safelist-Donuts
accountant!	Safelist-Chris-Abuse-TLDS, Safelist-Chris-Black-TLDS
accountants!	Safelist-Chris-Abuse-TLDS, Safelist-Chris-Black-TLDS, Safelist-Donuts
aco!	Safelist-Chris-Abuse-TLDS
action!	Safelist-Chris-Abuse-TLDS, Safelist-Chris-Black-TLDS
actor!	Safelist-Chris-Abuse-TLDS, Safelist-Chris-Suspicious-TLDS, Safelist-Donuts
ad!	Safelist-Chris-Abuse-TLDS, Safelist-Chris-Black-TLDS
ads!	Safelist-Chris-Abuse-TLDS
adult!	Safelist-Chris-Abuse-TLDS, Safelist-Chris-Black-TLDS
ae!	Safelist-Chris-Abuse-TLDS
aeg!	Safelist-Chris-Abuse-TLDS
aero!	Safelist-Chris-Abuse-TLDS, Safelist-Chris-Suspicious-TLDS
af!	Safelist-Chris-Abuse-TLDS
afamilycompany!	Safelist-Chris-Abuse-TLDS, Safelist-Chris-Black-TLDS
afl!	Safelist-Chris-Abuse-TLDS
africa!	Safelist-Chris-Abuse-TLDS, Safelist-Chris-Suspicious-TLDS
ag!	Safelist-Chris-Abuse-TLDS
agakhan!	Safelist-Chris-Suspicious-TLDS
agency!	Safelist-Chris-Abuse-TLDS, Safelist-Chris-Black-TLDS, Safelist-Donuts
ai!	Safelist-Chris-Suspicious-TLDS
airforce!	Safelist-Chris-Suspicious-TLDS, Safelist-Donuts
alibaba!	Safelist-Chris-Suspicious-TLDS
alipay!	Safelist-Chris-Suspicious-TLDS
allow!	Safelist-Chris-Abuse-TLDS
am!	Safelist-Chris-Abuse-TLDS
an!	Safelist-Chris-Abuse-TLDS, Safelist-Chris-Black-TLDS
analytic!	Safelist-Chris-Abuse-TLDS, Safelist-Chris-Black-TLDS
analytics!	Safelist-Chris-Abuse-TLDS, Safelist-Chris-Black-TLDS
anquan!	Safelist-Chris-Suspicious-TLDS
apartments!	Safelist-Chris-Suspicious-TLDS, Safelist-Donuts
aq!	Safelist-Chris-Abuse-TLDS
aquarelle!	Safelist-Chris-Suspicious-TLDS
arab!	Safelist-Chris-Suspicious-TLDS, Safelist-Collision, Safelist-Dotless
archi!	Safelist-Chris-Suspicious-TLDS, Safelist-Donuts
army!	Safelist-Chris-Suspicious-TLDS, Safelist-Donuts
arpa!	Safelist-Chris-Suspicious-TLDS
arris!	Safelist-Chris-Abuse-TLDS
art!	Safelist-Chris-Abuse-TLDS, Safelist-Chris-Black-TLDS
ashx!	Safelist-Chris-Abuse-TLDS, Safelist-Chris-Black-TLDS
asia!	Safelist-Chris-Abuse-TLDS, Safelist-Chris-Black-TLDS
asmx!	Safelist-Chris-Abuse-TLDS, Safelist-Chris-Black-TLDS
asp!	Safelist-Chris-Abuse-TLDS, Safelist-Chris-Black-TLDS
aspx!	Safelist-Chris-Abuse-TLDS, Safelist-Chris-Black-TLDS
associates!	Safelist-Chris-Abuse-TLDS, Safelist-Chris-Suspicious-TLDS, Safelist-Donuts
asus!	Safelist-Chris-Abuse-TLDS
asx!	Safelist-Chris-Abuse-TLDS, Safelist-Chris-Black-TLDS
ati!	Safelist-Chris-Abuse-TLDS
attorney!	Safelist-Chris-Suspicious-TLDS, Safelist-Donuts
auction!	Safelist-Chris-Abuse-TLDS, Safelist-Chris-Black-TLDS, Safelist-Donuts
audio!	Safelist-Chris-Suspicious-TLDS
auto!	Safelist-Chris-Suspicious-TLDS
autos!	Safelist-Include, Safelist-Chris-Abuse-TLDS, Safelist-Chris-Suspicious-TLDS
aws!	Safelist-Chris-Suspicious-TLDS
axd!	Safelist-Chris-Abuse-TLDS, Safelist-Chris-Black-TLDS
az!	Safelist-Chris-Abuse-TLDS
baby!	Safelist-Chris-Suspicious-TLDS
badalg!	Safelist-Chris-Abuse-TLDS, Safelist-Chris-Black-TLDS
badcookie!	Safelist-Chris-Abuse-TLDS
badkey!	Safelist-Chris-Abuse-TLDS, Safelist-Chris-Black-TLDS
badmode!	Safelist-Chris-Abuse-TLDS, Safelist-Chris-Black-TLDS
badname!	Safelist-Chris-Abuse-TLDS, Safelist-Chris-Black-TLDS
badsig!	Safelist-Chris-Abuse-TLDS
badtime!	Safelist-Chris-Abuse-TLDS, Safelist-Chris-Black-TLDS
badtrunc!	Safelist-Chris-Abuse-TLDS
badvers!	Safelist-Chris-Abuse-TLDS
band!	Safelist-Chris-Suspicious-TLDS, Safelist-Donuts
bapuji!	Safelist-Chris-Abuse-TLDS
bar!	Safelist-Chris-Abuse-TLDS, Safelist-Chris-Black-TLDS
bargain!	Safelist-Chris-Abuse-TLDS
bargains!	Safelist-Chris-Abuse-TLDS, Safelist-Chris-Black-TLDS, Safelist-Donuts
bash!	Safelist-Chris-Abuse-TLDS, Safelist-Chris-Black-TLDS
bat!	Safelist-Chris-Abuse-TLDS, Safelist-Chris-Black-TLDS
bayern!	Safelist-Chris-Suspicious-TLDS
baza!	Safelist-Chris-Abuse-TLDS
bazar!	Safelist-Chris-Abuse-TLDS, Safelist-Chris-Black-TLDS, Safelist-OpenNic
bbrouter!	Safelist-Chris-Abuse-TLDS
bbs!	Safelist-Chris-Abuse-TLDS, Safelist-Chris-Black-TLDS, Safelist-OpenNic
bd!	Safelist-Chris-Abuse-TLDS, Safelist-Dotless
beauty!	Safelist-Chris-Abuse-TLDS, Safelist-SpamHaus
beer!	Safelist-Chris-Suspicious-TLDS
bel!	Safelist-Chris-Abuse-TLDS
belkin!	Safelist-Chris-Abuse-TLDS
best!	Safelist-Chris-Abuse-TLDS, Safelist-Chris-Suspicious-TLDS, Safelist-SpamHaus
bet!	Safelist-Chris-Abuse-TLDS, Safelist-Chris-Black-TLDS, Safelist-Donuts
bh!	Safelist-Chris-Abuse-TLDS
bible!	Safelist-Chris-Suspicious-TLDS
bid!	Safelist-Chris-Abuse-TLDS, Safelist-Chris-Black-TLDS
bike!	Safelist-Chris-Abuse-TLDS, Safelist-Chris-Black-TLDS, Safelist-Donuts
bin!	Safelist-Chris-Abuse-TLDS
bind!	Safelist-Chris-Abuse-TLDS, Safelist-Chris-Black-TLDS
bingo!	Safelist-Chris-Abuse-TLDS, Safelist-Donuts
bio!	Safelist-Chris-Abuse-TLDS, Safelist-Chris-Suspicious-TLDS, Safelist-Donuts
bit!	Safelist-Chris-Abuse-TLDS, Safelist-Chris-Black-TLDS
bitcoin!	Safelist-Include, Safelist-Chris-Abuse-TLDS, Safelist-Chris-Black-TLDS
bitnet!	Safelist-Chris-Abuse-TLDS
biz!	Safelist-Chris-Abuse-TLDS, Safelist-Chris-Black-TLDS, Safelist-Restricted
bl!	Safelist-Chris-Abuse-TLDS, Safelist-Chris-Black-TLDS
black!	Safelist-Chris-Abuse-TLDS, Safelist-Chris-Black-TLDS, Safelist-Donuts
blackfriday!	Safelist-Chris-Abuse-TLDS
blinkap!	Safelist-Chris-Abuse-TLDS
block!	Safelist-Chris-Abuse-TLDS
blockchain!	Safelist-Include
blog!	Safelist-Chris-Abuse-TLDS, Safelist-Chris-Black-TLDS
blue!	Safelist-Chris-Abuse-TLDS, Safelist-Chris-Black-TLDS, Safelist-Donuts
boats!	Safelist-Chris-Abuse-TLDS, Safelist-Chris-Suspicious-TLDS, Safelist-SpamHaus
bond!	Safelist-Chris-Suspicious-TLDS
book!	Safelist-Chris-Suspicious-TLDS
booking!	Safelist-Chris-Suspicious-TLDS
boston!	Safelist-Chris-Abuse-TLDS, Safelist-Chris-Suspicious-TLDS
bot!	Safelist-Chris-Suspicious-TLDS
boutique!	Safelist-Chris-Abuse-TLDS, Safelist-Chris-Suspicious-TLDS, Safelist-Donuts
box!	Safelist-Chris-Abuse-TLDS
br!	Safelist-Chris-Abuse-TLDS, Safelist-Chris-Black-TLDS
bradesco!	Safelist-Donuts
broadcasthost!	Safelist-Chris-Abuse-TLDS, Safelist-Chris-Black-TLDS
broker!	Safelist-Chris-Suspicious-TLDS, Safelist-Donuts
brother!	Safelist-Chris-Suspicious-TLDS
brown!	Safelist-Chris-Suspicious-TLDS
budapest!	Safelist-Chris-Suspicious-TLDS
build!	Safelist-Chris-Suspicious-TLDS
builders!	Safelist-Chris-Suspicious-TLDS, Safelist-Donuts
business!	Safelist-Chris-Abuse-TLDS, Safelist-Donuts
buy!	Safelist-Chris-Abuse-TLDS
buzz!	Safelist-Chris-Abuse-TLDS, Safelist-Chris-Black-TLDS, Safelist-SpamHaus
bv!	Safelist-Chris-Abuse-TLDS
by!	Safelist-Chris-Abuse-TLDS
cab!	Safelist-Chris-Suspicious-TLDS, Safelist-Donuts
cafe!	Safelist-Chris-Suspicious-TLDS, Safelist-Donuts
cam!	Safelist-Chris-Abuse-TLDS, Safelist-Chris-Black-TLDS
camera!	Safelist-Chris-Suspicious-TLDS, Safelist-Donuts
camp!	Safelist-Chris-Suspicious-TLDS, Safelist-Donuts
capetown!	Safelist-Chris-Suspicious-TLDS
capital!	Safelist-Chris-Suspicious-TLDS, Safelist-Donuts
car!	Safelist-Chris-Suspicious-TLDS
card!	Safelist-Chris-Abuse-TLDS
cards!	Safelist-Chris-Abuse-TLDS, Safelist-Chris-Black-TLDS, Safelist-Donuts
care!	Safelist-Chris-Suspicious-TLDS, Safelist-Donuts
career!	Safelist-Chris-Abuse-TLDS, Safelist-Chris-Black-TLDS
careers!	Safelist-Chris-Abuse-TLDS, Safelist-Chris-Black-TLDS, Safelist-Donuts
cars!	Safelist-Chris-Suspicious-TLDS
casa!	Safelist-Chris-Abuse-TLDS, Safelist-Chris-Black-TLDS
cash!	Safelist-Chris-Abuse-TLDS, Safelist-Chris-Black-TLDS, Safelist-Donuts
casino!	Safelist-Chris-Abuse-TLDS, Safelist-Chris-Black-TLDS, Safelist-Donuts
cat!	Safelist-Chris-Abuse-TLDS, Safelist-Chris-Black-TLDS
catering!	Safelist-Chris-Suspicious-TLDS, Safelist-Donuts
catholic!	Safelist-Chris-Suspicious-TLDS
cc!	Safelist-Chris-Abuse-TLDS, Safelist-Chris-Black-TLDS
cd!	Safelist-Chris-Abuse-TLDS
center!	Safelist-Chris-Abuse-TLDS, Safelist-Donuts
ceo!	Safelist-Chris-Suspicious-TLDS
cf!	Safelist-Chris-Abuse-TLDS, Safelist-Chris-Black-TLDS, Safelist-SpamHaus
cfd!	Safelist-Chris-Abuse-TLDS, Safelist-SpamHaus
cfm!	Safelist-Chris-Abuse-TLDS, Safelist-Chris-Black-TLDS
cgi!	Safelist-Chris-Abuse-TLDS, Safelist-Chris-Black-TLDS
chain!	Safelist-Chris-Abuse-TLDS
chan!	Safelist-Chris-Abuse-TLDS, Safelist-Chris-Black-TLDS, Safelist-OpenNic
charity!	Safelist-Chris-Abuse-TLDS, Safelist-Chris-Suspicious-TLDS, Safelist-Donuts, Safelist-SpamHaus
chat!	Safelist-Chris-Abuse-TLDS, Safelist-Donuts
cheap!	Safelist-Chris-Suspicious-TLDS, Safelist-Donuts
chn!	Safelist-Chris-Abuse-TLDS, Safelist-Chris-Black-TLDS
christmas!	Safelist-Chris-Abuse-TLDS, Safelist-Chris-Black-TLDS, Safelist-SpamHaus
church!	Safelist-Chris-Abuse-TLDS, Safelist-Donuts
ci!	Safelist-Chris-Abuse-TLDS
cisco!	Safelist-Chris-Abuse-TLDS
citic!	Safelist-Chris-Suspicious-TLDS
city!	Safelist-Chris-Suspicious-TLDS, Safelist-Donuts
cityeats!	Safelist-Chris-Suspicious-TLDS
cl!	Safelist-Chris-Abuse-TLDS
claims!	Safelist-Chris-Suspicious-TLDS, Safelist-Donuts
cleaning!	Safelist-Chris-Suspicious-TLDS, Safelist-Donuts
click!	Safelist-Chris-Abuse-TLDS, Safelist-Chris-Black-TLDS
clinic!	Safelist-Chris-Suspicious-TLDS, Safelist-Donuts
clinique!	Safelist-Chris-Suspicious-TLDS
clothing!	Safelist-Chris-Suspicious-TLDS, Safelist-Donuts
club!	Safelist-Chris-Abuse-TLDS, Safelist-Chris-Black-TLDS
cm!	Safelist-Chris-Abuse-TLDS, Safelist-Chris-Black-TLDS, Safelist-Dotless
cmd!	Safelist-Chris-Abuse-TLDS, Safelist-Chris-Black-TLDS
cn!	Safelist-Chris-Abuse-TLDS, Safelist-Chris-Black-TLDS, Safelist-SpamHaus
cname!	Safelist-Chris-Abuse-TLDS
coach!	Safelist-Chris-Suspicious-TLDS, Safelist-Donuts
codes!	Safelist-Chris-Suspicious-TLDS, Safelist-Donuts
coffee!	Safelist-Chris-Suspicious-TLDS, Safelist-Donuts
coin!	Safelist-Include, Safelist-Chris-Abuse-TLDS, Safelist-Chris-Black-TLDS, Safelist-OpenNic
college!	Safelist-Chris-Suspicious-TLDS
example.com!	Safelist-Chris-Abuse-TLDS, Safelist-Chris-Black-TLDS
community!	Safelist-Chris-Suspicious-TLDS, Safelist-Donuts
company!	Safelist-Chris-Abuse-TLDS, Safelist-Chris-Black-TLDS, Safelist-Donuts
computer!	Safelist-Chris-Suspicious-TLDS, Safelist-Donuts
comsec!	Safelist-Chris-Suspicious-TLDS
condos!	Safelist-Chris-Suspicious-TLDS, Safelist-Donuts
construction!	Safelist-Chris-Suspicious-TLDS, Safelist-Donuts
consul!	Safelist-Chris-Abuse-TLDS
consulting!	Safelist-Chris-Suspicious-TLDS, Safelist-Donuts
contact!	Safelist-Chris-Suspicious-TLDS, Safelist-Donuts
contractors!	Safelist-Chris-Suspicious-TLDS, Safelist-Donuts
cookie!	Safelist-Chris-Abuse-TLDS
cooking!	Safelist-Chris-Suspicious-TLDS
cool!	Safelist-Chris-Abuse-TLDS, Safelist-Chris-Black-TLDS, Safelist-Donuts
coop!	Safelist-Chris-Suspicious-TLDS
corp!	Safelist-Chris-Abuse-TLDS, Safelist-Chris-Black-TLDS
corporate!	Safelist-Chris-Abuse-TLDS, Safelist-Chris-Black-TLDS
corsica!	Safelist-Chris-Suspicious-TLDS
country!	Safelist-Chris-Abuse-TLDS, Safelist-Chris-Black-TLDS
coupon!	Safelist-Chris-Suspicious-TLDS
coupons!	Safelist-Chris-Abuse-TLDS, Safelist-Chris-Suspicious-TLDS, Safelist-Donuts, Safelist-SpamHaus
courses!	Safelist-Chris-Suspicious-TLDS
cpa!	Safelist-Chris-Suspicious-TLDS
credit!	Safelist-Chris-Suspicious-TLDS, Safelist-Donuts
creditcard!	Safelist-Chris-Suspicious-TLDS, Safelist-Donuts
cricket!	Safelist-Chris-Abuse-TLDS, Safelist-Chris-Black-TLDS
crown!	Safelist-Chris-Suspicious-TLDS
cruise!	Safelist-Chris-Suspicious-TLDS
cruises!	Safelist-Chris-Suspicious-TLDS, Safelist-Donuts
crypto!	Safelist-Include, Safelist-Chris-Abuse-TLDS, Safelist-Chris-Black-TLDS
cs!	Safelist-Chris-Abuse-TLDS
csnet!	Safelist-Chris-Abuse-TLDS
css!	Safelist-Chris-Abuse-TLDS, Safelist-Chris-Black-TLDS
csv!	Safelist-Chris-Abuse-TLDS, Safelist-Chris-Black-TLDS
cy!	Safelist-Chris-Abuse-TLDS, Safelist-Chris-Black-TLDS
cyb!	Safelist-Chris-Abuse-TLDS, Safelist-Chris-Black-TLDS, Safelist-OpenNic
cym!	Safelist-Chris-Abuse-TLDS
cyou!	Safelist-Include, Safelist-Chris-Abuse-TLDS, Safelist-Chris-Suspicious-TLDS, Safelist-SpamHaus
dad!	Safelist-Chris-Suspicious-TLDS
dance!	Safelist-Chris-Abuse-TLDS, Safelist-Chris-Suspicious-TLDS, Safelist-Donuts
dao!	Safelist-Include
dat!	Safelist-Chris-Abuse-TLDS, Safelist-Chris-Black-TLDS
data!	Safelist-Chris-Abuse-TLDS, Safelist-Chris-Black-TLDS
date!	Safelist-Chris-Abuse-TLDS, Safelist-Chris-Black-TLDS, Safelist-SpamHaus
dating!	Safelist-Chris-Suspicious-TLDS, Safelist-Donuts
davolink!	Safelist-Chris-Abuse-TLDS
day!	Safelist-Chris-Suspicious-TLDS
dclk!	Safelist-Chris-Abuse-TLDS, Safelist-Chris-Black-TLDS
dd!	Safelist-Chris-Abuse-TLDS
deal!	Safelist-Chris-Suspicious-TLDS
dealer!	Safelist-Chris-Suspicious-TLDS
deals!	Safelist-Chris-Suspicious-TLDS, Safelist-Donuts
degree!	Safelist-Chris-Abuse-TLDS, Safelist-Chris-Suspicious-TLDS, Safelist-Donuts, Safelist-SpamHaus
delivery!	Safelist-Chris-Suspicious-TLDS, Safelist-Donuts
democrat!	Safelist-Chris-Suspicious-TLDS, Safelist-Donuts
dental!	Safelist-Chris-Suspicious-TLDS, Safelist-Donuts
dentist!	Safelist-Chris-Suspicious-TLDS, Safelist-Donuts
deny!	Safelist-Chris-Abuse-TLDS
desi!	Safelist-Chris-Abuse-TLDS, Safelist-Chris-Black-TLDS
design!	Safelist-Chris-Abuse-TLDS, Safelist-Chris-Black-TLDS
device!	Safelist-Chris-Abuse-TLDS
dhcp!	Safelist-Chris-Abuse-TLDS
diamonds!	Safelist-Chris-Suspicious-TLDS, Safelist-Donuts
diet!	Safelist-Chris-Abuse-TLDS, Safelist-Chris-Black-TLDS
dig!	Safelist-Chris-Abuse-TLDS, Safelist-Chris-Black-TLDS
digital!	Safelist-Chris-Abuse-TLDS, Safelist-Donuts
direct!	Safelist-Chris-Suspicious-TLDS, Safelist-Donuts
directory!	Safelist-Chris-Suspicious-TLDS, Safelist-Donuts
discount!	Safelist-Chris-Abuse-TLDS, Safelist-Donuts
discover!	Safelist-Chris-Suspicious-TLDS
dish!	Safelist-Chris-Suspicious-TLDS
diwali!	Safelist-Chris-Abuse-TLDS
diy!	Safelist-Chris-Suspicious-TLDS
dlink!	Safelist-Chris-Abuse-TLDS
dlinkrouter!	Safelist-Chris-Abuse-TLDS
dll!	Safelist-Chris-Abuse-TLDS, Safelist-Chris-Black-TLDS
dns!	Safelist-Chris-Abuse-TLDS, Safelist-OpenNic
do!	Safelist-Chris-Abuse-TLDS, Safelist-Chris-Black-TLDS
doc!	Safelist-Chris-Abuse-TLDS, Safelist-Chris-Black-TLDS
docs!	Safelist-Chris-Abuse-TLDS, Safelist-Chris-Black-TLDS
doctor!	Safelist-Chris-Suspicious-TLDS, Safelist-Donuts
docx!	Safelist-Chris-Abuse-TLDS, Safelist-Chris-Black-TLDS
doesnotexist!	Safelist-Chris-Abuse-TLDS
dog!	Safelist-Chris-Abuse-TLDS, Safelist-Chris-Black-TLDS, Safelist-Donuts
doha!	Safelist-Chris-Suspicious-TLDS
dom!	Safelist-Chris-Suspicious-TLDS
domain!	Safelist-Chris-Abuse-TLDS, Safelist-Chris-Black-TLDS
domains!	Safelist-Chris-Suspicious-TLDS, Safelist-Donuts
dot!	Safelist-Chris-Abuse-TLDS, Safelist-Chris-Black-TLDS
download!	Safelist-Chris-Abuse-TLDS, Safelist-Chris-Black-TLDS
drive!	Safelist-Chris-Suspicious-TLDS
dsotypeni!	Safelist-Chris-Abuse-TLDS
dubai!	Safelist-Chris-Suspicious-TLDS
duck!	Safelist-Chris-Abuse-TLDS, Safelist-Chris-Black-TLDS
dummy!	Safelist-Chris-Abuse-TLDS
durban!	Safelist-Chris-Suspicious-TLDS
dyn!	Safelist-Chris-Abuse-TLDS, Safelist-Chris-Black-TLDS, Safelist-OpenNic
dz!	Safelist-Chris-Abuse-TLDS, Safelist-Chris-Black-TLDS
earth!	Safelist-Chris-Abuse-TLDS
easter!	Safelist-Chris-Abuse-TLDS
eat!	Safelist-Chris-Suspicious-TLDS
eco!	Safelist-Chris-Abuse-TLDS
ecs!	Safelist-Chris-Abuse-TLDS
edns!	Safelist-Chris-Abuse-TLDS
education!	Safelist-Chris-Suspicious-TLDS, Safelist-Donuts
ee!	Safelist-Chris-Abuse-TLDS
eg!	Safelist-Chris-Abuse-TLDS, Safelist-Chris-Black-TLDS
eh!	Safelist-Chris-Abuse-TLDS
eio!	Safelist-Chris-Abuse-TLDS
email!	Safelist-Chris-Abuse-TLDS, Safelist-Chris-Black-TLDS, Safelist-Donuts
emc!	Safelist-Chris-Abuse-TLDS, Safelist-Chris-Black-TLDS, Safelist-OpenNic
emerck!	Safelist-Chris-Suspicious-TLDS
energy!	Safelist-Chris-Suspicious-TLDS, Safelist-Donuts
eng!	Safelist-Chris-Abuse-TLDS
engeniusrouter!	Safelist-Chris-Abuse-TLDS
engineer!	Safelist-Chris-Suspicious-TLDS, Safelist-Donuts
engineering!	Safelist-Chris-Suspicious-TLDS, Safelist-Donuts
enterprises!	Safelist-Chris-Suspicious-TLDS, Safelist-Donuts
epic!	Safelist-Chris-Abuse-TLDS, Safelist-OpenNic
epost!	Safelist-Chris-Abuse-TLDS
equipment!	Safelist-Chris-Suspicious-TLDS, Safelist-Donuts
ericsson!	Safelist-Chris-Suspicious-TLDS
estate!	Safelist-Chris-Suspicious-TLDS, Safelist-Donuts
esurance!	Safelist-Chris-Suspicious-TLDS
etc!	Safelist-Chris-Abuse-TLDS
eth!	Safelist-Chris-Abuse-TLDS, Safelist-Chris-Black-TLDS
eurovision!	Safelist-Chris-Suspicious-TLDS
events!	Safelist-Chris-Suspicious-TLDS, Safelist-Donuts
example!	Safelist-Chris-Abuse-TLDS, Safelist-Chris-Black-TLDS
exchange!	Safelist-Chris-Suspicious-TLDS, Safelist-Donuts
exe!	Safelist-Chris-Abuse-TLDS, Safelist-Chris-Black-TLDS
exit!	Safelist-Chris-Abuse-TLDS, Safelist-Chris-Black-TLDS
expert!	Safelist-Chris-Suspicious-TLDS, Safelist-Donuts
exposed!	Safelist-Chris-Abuse-TLDS, Safelist-Chris-Suspicious-TLDS, Safelist-Donuts
express!	Safelist-Chris-Suspicious-TLDS, Safelist-Donuts
extraspace!	Safelist-Chris-Suspicious-TLDS
fail!	Safelist-Chris-Abuse-TLDS, Safelist-Chris-Black-TLDS, Safelist-Donuts
faith!	Safelist-Chris-Abuse-TLDS, Safelist-Chris-Black-TLDS
fam!	Safelist-Chris-Abuse-TLDS, Safelist-Chris-Black-TLDS
family!	Safelist-Chris-Abuse-TLDS, Safelist-Donuts
fan!	Safelist-Chris-Suspicious-TLDS, Safelist-Donuts
fans!	Safelist-Chris-Suspicious-TLDS
farm!	Safelist-Chris-Abuse-TLDS, Safelist-Donuts
farmers!	Safelist-Chris-Suspicious-TLDS
fashion!	Safelist-Chris-Suspicious-TLDS
fast!	Safelist-Chris-Suspicious-TLDS
feedback!	Safelist-Chris-Suspicious-TLDS
feorge!	Safelist-Chris-Suspicious-TLDS
fidelity!	Safelist-Chris-Suspicious-TLDS
fido!	Safelist-Chris-Suspicious-TLDS
film!	Safelist-Chris-Suspicious-TLDS
final!	Safelist-Chris-Suspicious-TLDS
finance!	Safelist-Chris-Suspicious-TLDS, Safelist-Donuts
financial!	Safelist-Chris-Abuse-TLDS, Safelist-Chris-Suspicious-TLDS, Safelist-Donuts
fire!	Safelist-Chris-Suspicious-TLDS
fish!	Safelist-Chris-Abuse-TLDS, Safelist-Donuts
fishing!	Safelist-Chris-Abuse-TLDS, Safelist-Chris-Suspicious-TLDS, Safelist-SpamHaus
fit!	Safelist-Chris-Abuse-TLDS, Safelist-Chris-Black-TLDS
fitness!	Safelist-Chris-Suspicious-TLDS, Safelist-Donuts
flights!	Safelist-Chris-Suspicious-TLDS, Safelist-Donuts
florist!	Safelist-Chris-Suspicious-TLDS, Safelist-Donuts
flowers!	Safelist-Chris-Suspicious-TLDS
fly!	Safelist-Chris-Suspicious-TLDS
food!	Safelist-Chris-Suspicious-TLDS
football!	Safelist-Chris-Suspicious-TLDS, Safelist-Donuts
forex!	Safelist-Chris-Suspicious-TLDS, Safelist-Donuts
formerr!	Safelist-Chris-Abuse-TLDS, Safelist-Chris-Black-TLDS
forsale!	Safelist-Chris-Suspicious-TLDS, Safelist-Donuts
foundation!	Safelist-Chris-Suspicious-TLDS, Safelist-Donuts
free!	Safelist-Chris-Abuse-TLDS, Safelist-Chris-Black-TLDS, Safelist-OpenNic
frontdoor!	Safelist-Chris-Suspicious-TLDS
frontier!	Safelist-Chris-Suspicious-TLDS
ftp!	Safelist-Chris-Abuse-TLDS, Safelist-Chris-Black-TLDS
fun!	Safelist-Chris-Abuse-TLDS, Safelist-Chris-Black-TLDS
fund!	Safelist-Chris-Suspicious-TLDS, Safelist-Donuts
fur!	Safelist-Chris-Abuse-TLDS, Safelist-Chris-Black-TLDS, Safelist-OpenNic
furniture!	Safelist-Chris-Suspicious-TLDS, Safelist-Donuts
futbol!	Safelist-Chris-Suspicious-TLDS, Safelist-Donuts
fw!	Safelist-Chris-Abuse-TLDS
fyi!	Safelist-Chris-Abuse-TLDS, Safelist-Chris-Suspicious-TLDS, Safelist-Donuts, Safelist-SpamHaus
ga!	Safelist-Chris-Abuse-TLDS, Safelist-Chris-Black-TLDS, Safelist-SpamHaus
gallery!	Safelist-Chris-Suspicious-TLDS, Safelist-Donuts
game!	Safelist-Chris-Abuse-TLDS, Safelist-Chris-Black-TLDS
games!	Safelist-Chris-Abuse-TLDS, Safelist-Chris-Black-TLDS, Safelist-Donuts
garden!	Safelist-Chris-Abuse-TLDS, Safelist-Chris-Suspicious-TLDS
gateway!	Safelist-Chris-Abuse-TLDS
gay!	Safelist-Chris-Abuse-TLDS, Safelist-Chris-Black-TLDS
gb!	Safelist-Chris-Abuse-TLDS
gbiz!	Safelist-Chris-Suspicious-TLDS
gdn!	Safelist-Chris-Abuse-TLDS, Safelist-Chris-Black-TLDS
geek!	Safelist-Chris-Abuse-TLDS, Safelist-Chris-Black-TLDS, Safelist-OpenNic
gent!	Safelist-Chris-Suspicious-TLDS
genting!	Safelist-Chris-Suspicious-TLDS
getcacheddhcpresultsforcurrentconfig!	Safelist-Chris-Abuse-TLDS
gg!	Safelist-Chris-Abuse-TLDS
gif!	Safelist-Chris-Abuse-TLDS
gift!	Safelist-Chris-Suspicious-TLDS
gifts!	Safelist-Chris-Suspicious-TLDS, Safelist-Donuts
gives!	Safelist-Include, Safelist-Chris-Suspicious-TLDS, Safelist-Donuts
giving!	Safelist-Chris-Abuse-TLDS, Safelist-Chris-Suspicious-TLDS, Safelist-Donuts, Safelist-SpamHaus
glade!	Safelist-Chris-Abuse-TLDS, Safelist-Chris-Black-TLDS
glass!	Safelist-Chris-Suspicious-TLDS, Safelist-Donuts
global!	Safelist-Chris-Suspicious-TLDS, Safelist-Donuts
glue!	Safelist-Chris-Abuse-TLDS, Safelist-Chris-Black-TLDS
gmail!	Safelist-Chris-Suspicious-TLDS
gmbh!	Safelist-Chris-Suspicious-TLDS, Safelist-Donuts
gold!	Safelist-Chris-Suspicious-TLDS, Safelist-Donuts
goldpoint!	Safelist-Chris-Suspicious-TLDS
golf!	Safelist-Chris-Suspicious-TLDS, Safelist-Donuts
gop!	Safelist-Chris-Suspicious-TLDS
gopher!	Safelist-Chris-Abuse-TLDS, Safelist-Chris-Black-TLDS, Safelist-OpenNic
got!	Safelist-Chris-Suspicious-TLDS
gq!	Safelist-Chris-Abuse-TLDS, Safelist-Chris-Black-TLDS, Safelist-SpamHaus
grainger!	Safelist-Chris-Suspicious-TLDS
graphics!	Safelist-Chris-Suspicious-TLDS, Safelist-Donuts
gratis!	Safelist-Chris-Suspicious-TLDS, Safelist-Donuts
green!	Safelist-Chris-Abuse-TLDS, Safelist-Chris-Black-TLDS, Safelist-Donuts
gripe!	Safelist-Chris-Suspicious-TLDS, Safelist-Donuts
grocery!	Safelist-Chris-Suspicious-TLDS
group!	Safelist-Chris-Abuse-TLDS, Safelist-Chris-Black-TLDS, Safelist-Donuts
gs!	Safelist-Chris-Abuse-TLDS
guge!	Safelist-Chris-Suspicious-TLDS
guide!	Safelist-Chris-Suspicious-TLDS, Safelist-Donuts
guitars!	Safelist-Chris-Suspicious-TLDS
guru!	Safelist-Chris-Abuse-TLDS, Safelist-Chris-Black-TLDS, Safelist-Donuts
gw!	Safelist-Chris-Abuse-TLDS
gz!	Safelist-Chris-Abuse-TLDS, Safelist-Chris-Black-TLDS
hair!	Safelist-Chris-Abuse-TLDS, Safelist-Chris-Suspicious-TLDS, Safelist-SpamHaus
hangout!	Safelist-Chris-Suspicious-TLDS
hanukkah!	Safelist-Chris-Abuse-TLDS
haus!	Safelist-Chris-Abuse-TLDS, Safelist-Chris-Suspicious-TLDS, Safelist-Donuts, Safelist-SpamHaus
health!	Safelist-Chris-Suspicious-TLDS
healthcare!	Safelist-Chris-Suspicious-TLDS, Safelist-Donuts
help!	Safelist-Chris-Abuse-TLDS, Safelist-Chris-Suspicious-TLDS
here!	Safelist-Chris-Suspicious-TLDS
hiphop!	Safelist-Chris-Suspicious-TLDS
hiv!	Safelist-Chris-Suspicious-TLDS
hk!	Safelist-Chris-Abuse-TLDS
hockey!	Safelist-Chris-Suspicious-TLDS, Safelist-Donuts
holdings!	Safelist-Chris-Suspicious-TLDS, Safelist-Donuts
holiday!	Safelist-Chris-Suspicious-TLDS, Safelist-Donuts
home!	Safelist-Chris-Abuse-TLDS, Safelist-Chris-Black-TLDS
homegoods!	Safelist-Chris-Suspicious-TLDS
homes!	Safelist-Chris-Suspicious-TLDS
homesense!	Safelist-Chris-Suspicious-TLDS
hongkong!	Safelist-Chris-Abuse-TLDS
horse!	Safelist-Chris-Abuse-TLDS
hospital!	Safelist-Chris-Suspicious-TLDS, Safelist-Donuts
host!	Safelist-Chris-Abuse-TLDS, Safelist-Chris-Black-TLDS
hosting!	Safelist-Chris-Suspicious-TLDS
hot!	Safelist-Chris-Suspicious-TLDS
hoteles!	Safelist-Chris-Suspicious-TLDS
hotels!	Safelist-Chris-Suspicious-TLDS
house!	Safelist-Chris-Suspicious-TLDS, Safelist-Donuts
how!	Safelist-Chris-Suspicious-TLDS
hr!	Safelist-Chris-Abuse-TLDS
htm!	Safelist-Chris-Abuse-TLDS, Safelist-Chris-Black-TLDS
html!	Safelist-Chris-Abuse-TLDS, Safelist-Chris-Black-TLDS
htmls!	Safelist-Chris-Abuse-TLDS
http!	Safelist-Chris-Abuse-TLDS
https!	Safelist-Chris-Abuse-TLDS
hub!	Safelist-Chris-Abuse-TLDS
ice!	Safelist-Chris-Suspicious-TLDS
icu!	Safelist-Chris-Abuse-TLDS, Safelist-Chris-Black-TLDS
id!	Safelist-Chris-Abuse-TLDS, Safelist-Chris-Black-TLDS
im!	Safelist-Chris-Abuse-TLDS
immo!	Safelist-Chris-Suspicious-TLDS, Safelist-Donuts
immobilien!	Safelist-Chris-Suspicious-TLDS, Safelist-Donuts
imrworld!	Safelist-Chris-Suspicious-TLDS
in!	Safelist-Chris-Abuse-TLDS, Safelist-Chris-Black-TLDS
inc!	Safelist-Chris-Abuse-TLDS
industries!	Safelist-Chris-Suspicious-TLDS, Safelist-Donuts
indy!	Safelist-Chris-Abuse-TLDS, Safelist-Chris-Black-TLDS, Safelist-OpenNic
infiniti!	Safelist-Chris-Suspicious-TLDS
info!	Safelist-Chris-Abuse-TLDS, Safelist-Chris-Black-TLDS, Safelist-Donuts
infos!	Safelist-Chris-Abuse-TLDS, Safelist-Chris-Black-TLDS
ink!	Safelist-Chris-Abuse-TLDS, Safelist-Chris-Black-TLDS, Safelist-SpamHaus
institute!	Safelist-Chris-Suspicious-TLDS, Safelist-Donuts
insurance!	Safelist-Chris-Suspicious-TLDS
insure!	Safelist-Chris-Suspicious-TLDS, Safelist-Donuts
int!	Safelist-Chris-Black-TLDS
internal!	Safelist-Chris-Abuse-TLDS
international!	Safelist-Chris-Suspicious-TLDS, Safelist-Donuts
intra!	Safelist-Chris-Abuse-TLDS
intranet!	Safelist-Chris-Abuse-TLDS, Safelist-Chris-Black-TLDS
invalid!	Safelist-Chris-Abuse-TLDS, Safelist-Chris-Black-TLDS
investments!	Safelist-Chris-Suspicious-TLDS, Safelist-Donuts
ip!	Safelist-Chris-Abuse-TLDS
iq!	Safelist-Chris-Abuse-TLDS
ir!	Safelist-Chris-Abuse-TLDS, Safelist-Chris-Black-TLDS
irish!	Safelist-Chris-Suspicious-TLDS, Safelist-Donuts
ist!	Safelist-Chris-Abuse-TLDS
istanbul!	Safelist-Chris-Abuse-TLDS
java!	Safelist-Chris-Abuse-TLDS
javascript!	Safelist-Chris-Abuse-TLDS, Safelist-Chris-Black-TLDS
je!	Safelist-Chris-Abuse-TLDS
jetzt!	Safelist-Chris-Abuse-TLDS, Safelist-Chris-Black-TLDS, Safelist-Donuts
jewelry!	Safelist-Chris-Suspicious-TLDS, Safelist-Donuts
jhtml!	Safelist-Chris-Abuse-TLDS, Safelist-Chris-Black-TLDS
jmp!	Safelist-Chris-Suspicious-TLDS
jnpl!	Safelist-Chris-Abuse-TLDS
jobs!	Safelist-Chris-Suspicious-TLDS
joburg!	Safelist-Chris-Suspicious-TLDS
jomodns!	Safelist-Chris-Abuse-TLDS
joy!	Safelist-Chris-Suspicious-TLDS
jp!	Safelist-Chris-Abuse-TLDS
jpeg!	Safelist-Chris-Abuse-TLDS
jpg!	Safelist-Chris-Abuse-TLDS
js!	Safelist-Chris-Abuse-TLDS, Safelist-Chris-Black-TLDS
json!	Safelist-Chris-Abuse-TLDS
jsp!	Safelist-Chris-Abuse-TLDS, Safelist-Chris-Black-TLDS
jspx!	Safelist-Chris-Abuse-TLDS, Safelist-Chris-Black-TLDS
juegos!	Safelist-Chris-Suspicious-TLDS, Safelist-Donuts
junior!	Safelist-Chris-Abuse-TLDS
jupiter!	Safelist-Chris-Abuse-TLDS
kaufen!	Safelist-Chris-Abuse-TLDS, Safelist-Donuts
ke!	Safelist-Chris-Abuse-TLDS
ker!	Safelist-Chris-Abuse-TLDS
kid!	Safelist-Chris-Abuse-TLDS
kids!	Safelist-Chris-Abuse-TLDS
kim!	Safelist-Chris-Abuse-TLDS, Safelist-Chris-Black-TLDS, Safelist-Donuts
kinder!	Safelist-Chris-Abuse-TLDS
kitchen!	Safelist-Chris-Suspicious-TLDS, Safelist-Donuts
kiwi!	Safelist-Chris-Suspicious-TLDS
ko!	Safelist-Chris-Abuse-TLDS, Safelist-Chris-Black-TLDS, Safelist-OpenNic
kom!	Safelist-Chris-Abuse-TLDS
kr!	Safelist-Chris-Abuse-TLDS
krd!	Safelist-Chris-Suspicious-TLDS
ku!	Safelist-Chris-Abuse-TLDS, Safelist-Chris-Black-TLDS, Safelist-OpenNic
kyoto!	Safelist-Chris-Suspicious-TLDS
lab!	Safelist-Chris-Abuse-TLDS, Safelist-Chris-Black-TLDS
lan!	Safelist-Chris-Abuse-TLDS, Safelist-Chris-Black-TLDS
land!	Safelist-Chris-Abuse-TLDS, Safelist-Donuts
lat!	Safelist-Include, Safelist-Chris-Abuse-TLDS
law!	Safelist-Chris-Abuse-TLDS
lawyer!	Safelist-Chris-Suspicious-TLDS, Safelist-Donuts
le!	Safelist-Chris-Abuse-TLDS
lease!	Safelist-Chris-Suspicious-TLDS, Safelist-Donuts
legal!	Safelist-Chris-Suspicious-TLDS, Safelist-Donuts
lgbt!	Safelist-Chris-Suspicious-TLDS, Safelist-Donuts
li!	Safelist-Chris-Abuse-TLDS
lib!	Safelist-Chris-Abuse-TLDS, Safelist-Chris-Black-TLDS, Safelist-OpenNic
libra!	Safelist-Chris-Abuse-TLDS, Safelist-Chris-Black-TLDS
libre!	Safelist-Chris-Abuse-TLDS, Safelist-Chris-Black-TLDS, Safelist-OpenNic
lic!	Safelist-Chris-Abuse-TLDS, Safelist-Chris-Black-TLDS
life!	Safelist-Chris-Abuse-TLDS, Safelist-Chris-Black-TLDS, Safelist-Donuts
lifeinsurance!	Safelist-Chris-Suspicious-TLDS
lifestyle!	Safelist-Chris-Suspicious-TLDS
lighting!	Safelist-Chris-Suspicious-TLDS, Safelist-Donuts
like!	Safelist-Chris-Suspicious-TLDS
limited!	Safelist-Chris-Abuse-TLDS, Safelist-Chris-Black-TLDS, Safelist-Donuts
limo!	Safelist-Chris-Suspicious-TLDS, Safelist-Donuts
link!	Safelist-Chris-Abuse-TLDS, Safelist-Chris-Black-TLDS, Safelist-SpamHaus
live!	Safelist-Chris-Abuse-TLDS, Safelist-Chris-Black-TLDS, Safelist-Donuts, Safelist-SpamHaus
living!	Safelist-Chris-Suspicious-TLDS
lk!	Safelist-Chris-Abuse-TLDS, Safelist-Chris-Black-TLDS
llc!	Safelist-Chris-Suspicious-TLDS, Safelist-Donuts
lli!	Safelist-Chris-Abuse-TLDS
llp!	Safelist-Chris-Abuse-TLDS, Safelist-SpamHaus
ln!	Safelist-Chris-Abuse-TLDS
loan!	Safelist-Chris-Abuse-TLDS, Safelist-Chris-Black-TLDS
loans!	Safelist-Chris-Abuse-TLDS, Safelist-Chris-Black-TLDS, Safelist-Donuts
locahost!	Safelist-Chris-Abuse-TLDS, Safelist-Chris-Black-TLDS
local!	Safelist-Chris-Abuse-TLDS, Safelist-Chris-Black-TLDS
localdomain!	Safelist-Chris-Abuse-TLDS, Safelist-Chris-Black-TLDS
localhost!	Safelist-Chris-Abuse-TLDS, Safelist-Chris-Black-TLDS
localnet!	Safelist-Chris-Abuse-TLDS, Safelist-Chris-Black-TLDS
locker!	Safelist-Chris-Suspicious-TLDS
locus!	Safelist-Chris-Suspicious-TLDS
loft!	Safelist-Chris-Suspicious-TLDS
lol!	Safelist-Chris-Abuse-TLDS, Safelist-Chris-Black-TLDS, Safelist-SpamHaus
london!	Safelist-Chris-Abuse-TLDS, Safelist-Chris-Suspicious-TLDS
lotte!	Safelist-Chris-Suspicious-TLDS
lotto!	Safelist-Chris-Abuse-TLDS, Safelist-Chris-Black-TLDS, Safelist-Donuts
love!	Safelist-Chris-Suspicious-TLDS
lt!	Safelist-Chris-Abuse-TLDS
ltd!	Safelist-Chris-Abuse-TLDS, Safelist-Chris-Black-TLDS, Safelist-Donuts
ltda!	Safelist-Chris-Abuse-TLDS, Safelist-Chris-Black-TLDS
lunar!	Safelist-Chris-Abuse-TLDS
luxe!	Safelist-Chris-Suspicious-TLDS
luxury!	Safelist-Chris-Suspicious-TLDS
lv!	Safelist-Chris-Abuse-TLDS
mail!	Safelist-Chris-Abuse-TLDS, Safelist-Chris-Black-TLDS
maison!	Safelist-Chris-Suspicious-TLDS, Safelist-Donuts
makeup!	Safelist-Chris-Abuse-TLDS, Safelist-Chris-Suspicious-TLDS, Safelist-SpamHaus
man!	Safelist-Chris-Suspicious-TLDS
management!	Safelist-Chris-Suspicious-TLDS, Safelist-Donuts
map!	Safelist-Chris-Abuse-TLDS
maps!	Safelist-Chris-Abuse-TLDS
market!	Safelist-Chris-Abuse-TLDS, Safelist-Donuts, Safelist-SpamHaus
marketing!	Safelist-Chris-Abuse-TLDS, Safelist-Donuts
markets!	Safelist-Chris-Suspicious-TLDS, Safelist-Donuts
mars!	Safelist-Chris-Abuse-TLDS
mba!	Safelist-Chris-Abuse-TLDS, Safelist-Chris-Suspicious-TLDS, Safelist-Donuts
md!	Safelist-Chris-Abuse-TLDS
me!	Safelist-Chris-Abuse-TLDS, Safelist-Chris-Black-TLDS
med!	Safelist-Chris-Abuse-TLDS
media!	Safelist-Chris-Abuse-TLDS, Safelist-Donuts
melbourne!	Safelist-Chris-Suspicious-TLDS
meme!	Safelist-Chris-Suspicious-TLDS
memorial!	Safelist-Chris-Suspicious-TLDS, Safelist-Donuts
men!	Safelist-Chris-Abuse-TLDS, Safelist-Chris-Black-TLDS, Safelist-SpamHaus
menu!	Safelist-Chris-Suspicious-TLDS
metric!	Safelist-Chris-Abuse-TLDS, Safelist-Chris-Black-TLDS
metrics!	Safelist-Chris-Abuse-TLDS, Safelist-Chris-Black-TLDS
mf!	Safelist-Chris-Abuse-TLDS
miami!	Safelist-Chris-Abuse-TLDS, Safelist-Chris-Suspicious-TLDS
mini!	Safelist-Chris-Suspicious-TLDS
mint!	Safelist-Chris-Suspicious-TLDS
ml!	Safelist-Chris-Abuse-TLDS, Safelist-Chris-Black-TLDS, Safelist-SpamHaus
mn!	Safelist-Chris-Abuse-TLDS, Safelist-Chris-Black-TLDS
mobi!	Safelist-Chris-Abuse-TLDS, Safelist-Chris-Black-TLDS, Safelist-Donuts
mobile!	Safelist-Chris-Abuse-TLDS
mockba!	Safelist-Chris-Abuse-TLDS
moda!	Safelist-Chris-Suspicious-TLDS, Safelist-Donuts
modem!	Safelist-Chris-Abuse-TLDS
moe!	Safelist-Chris-Abuse-TLDS, Safelist-Chris-Black-TLDS
moh!	Safelist-Chris-Abuse-TLDS
moi!	Safelist-Chris-Suspicious-TLDS
mom!	Safelist-Chris-Abuse-TLDS, Safelist-Chris-Black-TLDS
money!	Safelist-Chris-Suspicious-TLDS, Safelist-Donuts
monster!	Safelist-Chris-Abuse-TLDS, Safelist-Chris-Black-TLDS
moon!	Safelist-Chris-Abuse-TLDS
mormon!	Safelist-Chris-Suspicious-TLDS
mortgage!	Safelist-Chris-Suspicious-TLDS, Safelist-Donuts
moscow!	Safelist-Chris-Abuse-TLDS
moto!	Safelist-Chris-Suspicious-TLDS
motorcycles!	Safelist-Chris-Abuse-TLDS, Safelist-Chris-Suspicious-TLDS, Safelist-SpamHaus
mov!	Safelist-Chris-Abuse-TLDS
movie!	Safelist-Chris-Suspicious-TLDS, Safelist-Donuts
mpeg!	Safelist-Chris-Abuse-TLDS
mrmuscle!	Safelist-Chris-Abuse-TLDS, Safelist-Chris-Black-TLDS
mshome!	Safelist-Chris-Abuse-TLDS
museum!	Safelist-Chris-Suspicious-TLDS
mutual!	Safelist-Chris-Suspicious-TLDS
mw!	Safelist-Chris-Abuse-TLDS
my!	Safelist-Chris-Abuse-TLDS
mygateway!	Safelist-Chris-Abuse-TLDS
nagoya!	Safelist-Chris-Abuse-TLDS, Safelist-Chris-Black-TLDS
nai!	Safelist-Chris-Abuse-TLDS
name!	Safelist-Chris-Abuse-TLDS, Safelist-Chris-Black-TLDS, Safelist-Restricted, Safelist-SpamHaus
nationwide!	Safelist-Chris-Suspicious-TLDS
natura!	Safelist-Chris-Suspicious-TLDS
navy!	Safelist-Chris-Abuse-TLDS, Safelist-Chris-Suspicious-TLDS, Safelist-Donuts, Safelist-SpamHaus
ncsi!	Safelist-Chris-Abuse-TLDS
neo!	Safelist-Chris-Abuse-TLDS, Safelist-Chris-Black-TLDS, Safelist-OpenNic
neptune!	Safelist-Chris-Abuse-TLDS
example.net!	Safelist-Chris-Abuse-TLDS, Safelist-Chris-Black-TLDS
netbank!	Safelist-Chris-Suspicious-TLDS
network!	Safelist-Chris-Abuse-TLDS, Safelist-Chris-Black-TLDS, Safelist-Donuts
new!	Safelist-Chris-Suspicious-TLDS
newholland!	Safelist-Chris-Suspicious-TLDS
news!	Safelist-Chris-Suspicious-TLDS, Safelist-Donuts
next!	Safelist-Chris-Suspicious-TLDS
nextdirect!	Safelist-Chris-Suspicious-TLDS
nexus!	Safelist-Chris-Suspicious-TLDS
nf!	Safelist-Chris-Abuse-TLDS, Safelist-Chris-Black-TLDS, Safelist-SpamHaus
nft!	Safelist-Include
ngo!	Safelist-Chris-Abuse-TLDS, Safelist-Donuts
ninja!	Safelist-Chris-Abuse-TLDS, Safelist-Chris-Black-TLDS, Safelist-Donuts
nocookie!	Safelist-Chris-Abuse-TLDS
nodata!	Safelist-Chris-Abuse-TLDS, Safelist-Chris-Black-TLDS
noerror!	Safelist-Chris-Abuse-TLDS, Safelist-Chris-Black-TLDS
notauth!	Safelist-Chris-Abuse-TLDS, Safelist-Chris-Black-TLDS
notimp!	Safelist-Chris-Abuse-TLDS, Safelist-Chris-Black-TLDS
notzone!	Safelist-Chris-Abuse-TLDS, Safelist-Chris-Black-TLDS
now!	Safelist-Chris-Suspicious-TLDS
nowruz!	Safelist-Chris-Suspicious-TLDS
nowtv!	Safelist-Chris-Suspicious-TLDS
npo!	Safelist-Chris-Abuse-TLDS, Safelist-Chris-Black-TLDS
nra!	Safelist-Chris-Suspicious-TLDS
ns!	Safelist-Chris-Abuse-TLDS
nsid!	Safelist-Chris-Abuse-TLDS
nslookup!	Safelist-Chris-Abuse-TLDS, Safelist-Chris-Black-TLDS
null!	Safelist-Chris-Abuse-TLDS, Safelist-Chris-Black-TLDS, Safelist-OpenNic
nxdomain!	Safelist-Chris-Abuse-TLDS, Safelist-Chris-Black-TLDS
nxrrset!	Safelist-Chris-Abuse-TLDS, Safelist-Chris-Black-TLDS
nxt!	Safelist-Chris-Abuse-TLDS, Safelist-Chris-Black-TLDS
observer!	Safelist-Chris-Suspicious-TLDS
off!	Safelist-Chris-Abuse-TLDS, Safelist-Chris-Black-TLDS
office!	Safelist-Chris-Abuse-TLDS, Safelist-Chris-Black-TLDS
okinawa!	Safelist-Chris-Abuse-TLDS, Safelist-Chris-Black-TLDS, Safelist-SpamHaus
om!	Safelist-Chris-Abuse-TLDS
one!	Safelist-Chris-Abuse-TLDS
ong!	Safelist-Donuts
onion!	Safelist-Chris-Abuse-TLDS, Safelist-Chris-Black-TLDS
onl!	Safelist-Chris-Abuse-TLDS
online!	Safelist-Chris-Abuse-TLDS, Safelist-Chris-Black-TLDS
onyourside!	Safelist-Chris-Suspicious-TLDS
ooo!	Safelist-Chris-Abuse-TLDS, Safelist-Chris-Black-TLDS
open!	Safelist-Chris-Suspicious-TLDS
opendns!	Safelist-Chris-Abuse-TLDS
opennic!	Safelist-Chris-Abuse-TLDS, Safelist-OpenNic
openshift!	Safelist-Chris-Abuse-TLDS
openshiftlocal!	Safelist-Chris-Abuse-TLDS
openstack!	Safelist-Chris-Abuse-TLDS
openstacklocal!	Safelist-Chris-Abuse-TLDS
opr!	Safelist-Chris-Abuse-TLDS
example.org!	Safelist-Chris-Abuse-TLDS, Safelist-Chris-Black-TLDS
organic!	Safelist-Chris-Abuse-TLDS, Safelist-Chris-Black-TLDS, Safelist-Donuts
origins!	Safelist-Chris-Suspicious-TLDS
osaka!	Safelist-Chris-Abuse-TLDS
oss!	Safelist-Chris-Abuse-TLDS, Safelist-Chris-Black-TLDS, Safelist-OpenNic
otsuka!	Safelist-Chris-Abuse-TLDS
ovh!	Safelist-Chris-Abuse-TLDS, Safelist-Chris-Black-TLDS
oz!	Safelist-Chris-Abuse-TLDS, Safelist-Chris-Black-TLDS, Safelist-OpenNic
pa!	Safelist-Chris-Abuse-TLDS
pac!	Safelist-Chris-Abuse-TLDS, Safelist-Chris-Black-TLDS
page!	Safelist-Chris-Suspicious-TLDS
parody!	Safelist-Chris-Abuse-TLDS, Safelist-Chris-Black-TLDS, Safelist-OpenNic
pars!	Safelist-Chris-Suspicious-TLDS
partners!	Safelist-Chris-Suspicious-TLDS, Safelist-Donuts
parts!	Safelist-Chris-Suspicious-TLDS, Safelist-Donuts
party!	Safelist-Chris-Abuse-TLDS, Safelist-Chris-Black-TLDS
passover!	Safelist-Chris-Abuse-TLDS
pay!	Safelist-Chris-Suspicious-TLDS
pdf!	Safelist-Chris-Abuse-TLDS, Safelist-Chris-Black-TLDS
per!	Safelist-Chris-Abuse-TLDS, Safelist-Chris-Black-TLDS
pet!	Safelist-Chris-Abuse-TLDS, Safelist-Chris-Black-TLDS, Safelist-Donuts
ph!	Safelist-Chris-Abuse-TLDS, Safelist-Chris-Black-TLDS
pharmacy!	Safelist-Chris-Abuse-TLDS, Safelist-Chris-Black-TLDS
phone!	Safelist-Chris-Suspicious-TLDS
photo!	Safelist-Chris-Abuse-TLDS, Safelist-Chris-Suspicious-TLDS
photography!	Safelist-Chris-Abuse-TLDS, Safelist-Chris-Black-TLDS, Safelist-Donuts
photos!	Safelist-Chris-Suspicious-TLDS, Safelist-Donuts
php!	Safelist-Chris-Abuse-TLDS, Safelist-Chris-Black-TLDS
phtml!	Safelist-Chris-Abuse-TLDS, Safelist-Chris-Black-TLDS
physio!	Safelist-Chris-Suspicious-TLDS
pics!	Safelist-Chris-Suspicious-TLDS
pictures!	Safelist-Chris-Suspicious-TLDS, Safelist-Donuts
pin!	Safelist-Chris-Suspicious-TLDS
ping!	Safelist-Chris-Suspicious-TLDS
pink!	Safelist-Chris-Abuse-TLDS, Safelist-Chris-Black-TLDS, Safelist-Donuts
pirate!	Safelist-Chris-Abuse-TLDS, Safelist-Chris-Black-TLDS, Safelist-OpenNic
pizza!	Safelist-Chris-Suspicious-TLDS, Safelist-Donuts
pk!	Safelist-Chris-Abuse-TLDS, Safelist-Chris-Black-TLDS
pl!	Safelist-Chris-Abuse-TLDS, Safelist-Chris-Black-TLDS
place!	Safelist-Chris-Suspicious-TLDS, Safelist-Donuts
play!	Safelist-Chris-Suspicious-TLDS
playstation!	Safelist-Chris-Suspicious-TLDS
plist!	Safelist-Chris-Abuse-TLDS, Safelist-Chris-Black-TLDS
plumbing!	Safelist-Chris-Suspicious-TLDS, Safelist-Donuts
plus!	Safelist-Chris-Suspicious-TLDS, Safelist-Donuts
pluto!	Safelist-Chris-Abuse-TLDS
pm!	Safelist-Chris-Abuse-TLDS, Safelist-Chris-Black-TLDS
png!	Safelist-Chris-Abuse-TLDS
pocketdata!	Safelist-Chris-Abuse-TLDS
poker!	Safelist-Chris-Abuse-TLDS, Safelist-Chris-Black-TLDS, Safelist-Donuts
porn!	Safelist-Chris-Abuse-TLDS, Safelist-Chris-Black-TLDS
porno!	Safelist-Chris-Abuse-TLDS, Safelist-Chris-Black-TLDS
post!	Safelist-Chris-Abuse-TLDS
ppt!	Safelist-Chris-Abuse-TLDS, Safelist-Chris-Black-TLDS
pptx!	Safelist-Chris-Abuse-TLDS, Safelist-Chris-Black-TLDS
pq!	Safelist-Chris-Abuse-TLDS
pramerica!	Safelist-Chris-Suspicious-TLDS
praxi!	Safelist-Chris-Suspicious-TLDS
press!	Safelist-Chris-Abuse-TLDS, Safelist-Chris-Black-TLDS
prime!	Safelist-Chris-Suspicious-TLDS
private!	Safelist-Chris-Abuse-TLDS, Safelist-Chris-Black-TLDS
pro!	Safelist-Chris-Abuse-TLDS, Safelist-Chris-Black-TLDS, Safelist-Restricted, Safelist-Donuts
prod!	Safelist-Chris-Suspicious-TLDS
productions!	Safelist-Chris-Suspicious-TLDS, Safelist-Donuts
prof!	Safelist-Chris-Suspicious-TLDS
progressive!	Safelist-Chris-Suspicious-TLDS
promo!	Safelist-Chris-Abuse-TLDS, Safelist-Chris-Black-TLDS, Safelist-Donuts, Safelist-SpamHaus
properties!	Safelist-Chris-Suspicious-TLDS, Safelist-Donuts
property!	Safelist-Chris-Suspicious-TLDS
protection!	Safelist-Chris-Suspicious-TLDS
ptr!	Safelist-Chris-Abuse-TLDS
pub!	Safelist-Chris-Suspicious-TLDS, Safelist-Donuts
purim!	Safelist-Chris-Abuse-TLDS
pvt!	Safelist-Chris-Abuse-TLDS, Safelist-Chris-Black-TLDS
pw!	Safelist-Chris-Abuse-TLDS, Safelist-Chris-Black-TLDS
py!	Safelist-Chris-Abuse-TLDS, Safelist-Chris-Black-TLDS
pyc!	Safelist-Chris-Abuse-TLDS
qpon!	Safelist-Chris-Suspicious-TLDS
quest!	Safelist-Include, Safelist-Chris-Abuse-TLDS, Safelist-SpamHaus
qvc!	Safelist-Chris-Suspicious-TLDS
racing!	Safelist-Chris-Abuse-TLDS, Safelist-Chris-Black-TLDS
radio!	Safelist-Chris-Suspicious-TLDS
raid!	Safelist-Chris-Abuse-TLDS, Safelist-Chris-Black-TLDS
rb!	Safelist-Chris-Abuse-TLDS, Safelist-Chris-Black-TLDS
read!	Safelist-Chris-Suspicious-TLDS
realestate!	Safelist-Chris-Suspicious-TLDS
realtek!	Safelist-Chris-Abuse-TLDS
realtor!	Safelist-Chris-Abuse-TLDS, Safelist-Chris-Black-TLDS
realty!	Safelist-Chris-Suspicious-TLDS
recipes!	Safelist-Chris-Suspicious-TLDS, Safelist-Donuts
red!	Safelist-Chris-Abuse-TLDS, Safelist-Donuts
redstone!	Safelist-Chris-Suspicious-TLDS
redumbrella!	Safelist-Chris-Suspicious-TLDS
refused!	Safelist-Chris-Abuse-TLDS, Safelist-Chris-Black-TLDS
rehab!	Safelist-Chris-Abuse-TLDS, Safelist-Chris-Suspicious-TLDS, Safelist-Donuts, Safelist-SpamHaus
reise!	Safelist-Chris-Abuse-TLDS, Safelist-Chris-Black-TLDS, Safelist-Donuts
reisen!	Safelist-Chris-Abuse-TLDS, Safelist-Donuts
reit!	Safelist-Chris-Suspicious-TLDS
reject!	Safelist-Chris-Abuse-TLDS, Safelist-Chris-Black-TLDS
rejected!	Safelist-Chris-Abuse-TLDS, Safelist-Chris-Black-TLDS
reliance!	Safelist-Chris-Suspicious-TLDS, Safelist-Donuts
ren!	Safelist-Chris-Abuse-TLDS, Safelist-Chris-Black-TLDS
rent!	Safelist-Chris-Suspicious-TLDS
rentals!	Safelist-Chris-Suspicious-TLDS, Safelist-Donuts
repair!	Safelist-Chris-Suspicious-TLDS, Safelist-Donuts
report!	Safelist-Chris-Suspicious-TLDS, Safelist-Donuts
republican!	Safelist-Chris-Suspicious-TLDS, Safelist-Donuts
rest!	Safelist-Chris-Abuse-TLDS, Safelist-SpamHaus
restaurant!	Safelist-Chris-Suspicious-TLDS, Safelist-Donuts
review!	Safelist-Chris-Abuse-TLDS, Safelist-Chris-Black-TLDS
reviews!	Safelist-Chris-Abuse-TLDS, Safelist-Chris-Black-TLDS, Safelist-Donuts
rhtml!	Safelist-Chris-Abuse-TLDS, Safelist-Chris-Black-TLDS
rich!	Safelist-Chris-Suspicious-TLDS
rightathome!	Safelist-Chris-Abuse-TLDS, Safelist-Chris-Black-TLDS
ril!	Safelist-Donuts
rio!	Safelist-Chris-Abuse-TLDS
rip!	Safelist-Chris-Abuse-TLDS, Safelist-Chris-Suspicious-TLDS, Safelist-Donuts, Safelist-SpamHaus
rm!	Safelist-Chris-Abuse-TLDS, Safelist-OpenNic
ro!	Safelist-Chris-Abuse-TLDS
rock!	Safelist-Chris-Abuse-TLDS
rocks!	Safelist-Chris-Abuse-TLDS, Safelist-Chris-Black-TLDS, Safelist-Donuts, Safelist-SpamHaus
rodeo!	Safelist-Chris-Abuse-TLDS, Safelist-SpamHaus
room!	Safelist-Chris-Suspicious-TLDS
root!	Safelist-Chris-Abuse-TLDS, Safelist-Chris-Black-TLDS
router!	Safelist-Chris-Abuse-TLDS, Safelist-Chris-Black-TLDS
rr!	Safelist-Chris-Abuse-TLDS, Safelist-Chris-Black-TLDS
rs!	Safelist-Chris-Abuse-TLDS
rss!	Safelist-Chris-Abuse-TLDS, Safelist-Chris-Black-TLDS
rsvp!	Safelist-Chris-Suspicious-TLDS
ru!	Safelist-Chris-Abuse-TLDS, Safelist-Chris-Black-TLDS
rugby!	Safelist-Chris-Abuse-TLDS, Safelist-Chris-Suspicious-TLDS, Safelist-SpamHaus
run!	Safelist-Chris-Abuse-TLDS, Safelist-Chris-Suspicious-TLDS, Safelist-Donuts, Safelist-SpamHaus
ryukyu!	Safelist-Chris-Abuse-TLDS, Safelist-Chris-Black-TLDS
safe!	Safelist-Chris-Abuse-TLDS, Safelist-Chris-Suspicious-TLDS
safety!	Safelist-Chris-Suspicious-TLDS
sakura!	Safelist-Chris-Suspicious-TLDS
sale!	Safelist-Chris-Abuse-TLDS, Safelist-Chris-Suspicious-TLDS, Safelist-Donuts, Safelist-SpamHaus
salon!	Safelist-Chris-Abuse-TLDS, Safelist-Chris-Black-TLDS, Safelist-Donuts
sarl!	Safelist-Chris-Suspicious-TLDS, Safelist-Donuts
saturn!	Safelist-Chris-Abuse-TLDS
save!	Safelist-Chris-Suspicious-TLDS
saxo!	Safelist-Chris-Suspicious-TLDS
sbs!	Safelist-Include, Safelist-Chris-Abuse-TLDS
scholarships!	Safelist-Chris-Suspicious-TLDS
school!	Safelist-Chris-Suspicious-TLDS, Safelist-Donuts
schule!	Safelist-Chris-Abuse-TLDS, Safelist-Chris-Black-TLDS, Safelist-Donuts
science!	Safelist-Chris-Abuse-TLDS, Safelist-Chris-Black-TLDS
scjohnson!	Safelist-Chris-Abuse-TLDS, Safelist-Chris-Black-TLDS
sco!	Safelist-Chris-Abuse-TLDS
script!	Safelist-Chris-Abuse-TLDS, Safelist-Chris-Black-TLDS
search!	Safelist-Chris-Suspicious-TLDS
seat!	Safelist-Chris-Suspicious-TLDS
secure!	Safelist-Chris-Abuse-TLDS, Safelist-Chris-Suspicious-TLDS
security!	Safelist-Chris-Suspicious-TLDS
seek!	Safelist-Chris-Suspicious-TLDS
seks!	Safelist-Chris-Abuse-TLDS, Safelist-Chris-Black-TLDS
select!	Safelist-Chris-Suspicious-TLDS
server!	Safelist-Chris-Abuse-TLDS, Safelist-Chris-Black-TLDS
servfail!	Safelist-Chris-Abuse-TLDS, Safelist-Chris-Black-TLDS
service!	Safelist-Chris-Abuse-TLDS
services!	Safelist-Chris-Abuse-TLDS, Safelist-Chris-Black-TLDS, Safelist-Donuts
seven!	Safelist-Chris-Suspicious-TLDS
sew!	Safelist-Chris-Abuse-TLDS, Safelist-SpamHaus
sex!	Safelist-Chris-Abuse-TLDS, Safelist-Chris-Black-TLDS, Safelist-SpamHaus
sexy!	Safelist-Chris-Abuse-TLDS, Safelist-Chris-Black-TLDS
sg!	Safelist-Chris-Abuse-TLDS
sh!	Safelist-Chris-Abuse-TLDS, Safelist-Chris-Black-TLDS
shangrila!	Safelist-Chris-Suspicious-TLDS
sharp!	Safelist-Chris-Suspicious-TLDS
shaw!	Safelist-Chris-Suspicious-TLDS
shell!	Safelist-Chris-Suspicious-TLDS
shia!	Safelist-Chris-Suspicious-TLDS
shiksha!	Safelist-Chris-Abuse-TLDS, Safelist-Donuts
shoes!	Safelist-Chris-Suspicious-TLDS, Safelist-Donuts
shop!	Safelist-Include, Safelist-Chris-Abuse-TLDS, Safelist-Chris-Black-TLDS
shopping!	Safelist-Chris-Suspicious-TLDS, Safelist-Donuts
shouji!	Safelist-Chris-Abuse-TLDS
show!	Safelist-Chris-Abuse-TLDS, Safelist-Donuts
showtime!	Safelist-Chris-Suspicious-TLDS
shriram!	Safelist-Chris-Suspicious-TLDS
shtml!	Safelist-Chris-Abuse-TLDS, Safelist-Chris-Black-TLDS
si!	Safelist-Chris-Suspicious-TLDS
sic!	Safelist-Chris-Abuse-TLDS
silk!	Safelist-Chris-Suspicious-TLDS
sina!	Safelist-Chris-Suspicious-TLDS
singles!	Safelist-Chris-Suspicious-TLDS, Safelist-Donuts
site!	Safelist-Chris-Abuse-TLDS, Safelist-Chris-Black-TLDS
size!	Safelist-Chris-Suspicious-TLDS
sj!	Safelist-Chris-Abuse-TLDS
ski!	Safelist-Chris-Suspicious-TLDS, Safelist-Donuts
skin!	Safelist-Include, Safelist-Chris-Abuse-TLDS, Safelist-Chris-Suspicious-TLDS
sling!	Safelist-Chris-Suspicious-TLDS
smart!	Safelist-Chris-Suspicious-TLDS
smile!	Safelist-Chris-Suspicious-TLDS
soa!	Safelist-Chris-Abuse-TLDS
soccer!	Safelist-Chris-Suspicious-TLDS, Safelist-Donuts
social!	Safelist-Chris-Suspicious-TLDS, Safelist-Donuts
software!	Safelist-Chris-Suspicious-TLDS, Safelist-Donuts
solar!	Safelist-Chris-Suspicious-TLDS, Safelist-Donuts
solution!	Safelist-Chris-Abuse-TLDS, Safelist-Chris-Black-TLDS
solutions!	Safelist-Chris-Abuse-TLDS, Safelist-Chris-Black-TLDS, Safelist-Donuts
song!	Safelist-Chris-Suspicious-TLDS
soy!	Safelist-Chris-Suspicious-TLDS
space!	Safelist-Chris-Abuse-TLDS, Safelist-Chris-Black-TLDS
sport!	Safelist-Chris-Abuse-TLDS
spot!	Safelist-Chris-Suspicious-TLDS
spreadbetting!	Safelist-Chris-Suspicious-TLDS
srl!	Safelist-Chris-Suspicious-TLDS
ssh!	Safelist-Chris-Abuse-TLDS
star!	Safelist-Chris-Suspicious-TLDS
storage!	Safelist-Chris-Suspicious-TLDS
store!	Safelist-Chris-Abuse-TLDS, Safelist-Chris-Suspicious-TLDS
stream!	Safelist-Chris-Abuse-TLDS, Safelist-Chris-Black-TLDS
studio!	Safelist-Chris-Suspicious-TLDS, Safelist-Donuts
study!	Safelist-Chris-Abuse-TLDS, Safelist-Chris-Black-TLDS
style!	Safelist-Chris-Abuse-TLDS, Safelist-Chris-Black-TLDS, Safelist-Donuts
su!	Safelist-Chris-Abuse-TLDS, Safelist-Chris-Black-TLDS
suck!	Safelist-Chris-Abuse-TLDS
sucks!	Safelist-Chris-Abuse-TLDS, Safelist-Chris-Black-TLDS
sun!	Safelist-Chris-Abuse-TLDS
supplies!	Safelist-Chris-Suspicious-TLDS, Safelist-Donuts
supply!	Safelist-Chris-Suspicious-TLDS, Safelist-Donuts
support!	Safelist-Chris-Abuse-TLDS, Safelist-Chris-Black-TLDS, Safelist-Donuts, Safelist-SpamHaus
surf!	Safelist-Chris-Abuse-TLDS, Safelist-Chris-Black-TLDS
surgery!	Safelist-Chris-Suspicious-TLDS, Safelist-Donuts
svg!	Safelist-Chris-Abuse-TLDS, Safelist-Chris-Black-TLDS
swf!	Safelist-Chris-Abuse-TLDS, Safelist-Chris-Black-TLDS
swift!	Safelist-Chris-Abuse-TLDS
swiss!	Safelist-Chris-Suspicious-TLDS
sx!	Safelist-Chris-Abuse-TLDS
sydney!	Safelist-Chris-Suspicious-TLDS
system!	Safelist-Chris-Abuse-TLDS
systems!	Safelist-Chris-Abuse-TLDS, Safelist-Donuts
sz!	Safelist-Chris-Abuse-TLDS, Safelist-SpamHaus
tab!	Safelist-Chris-Abuse-TLDS, Safelist-Chris-Black-TLDS
taipei!	Safelist-Chris-Abuse-TLDS
taiwan!	Safelist-Chris-Abuse-TLDS
taobao!	Safelist-Chris-Suspicious-TLDS, Safelist-Donuts
tar!	Safelist-Chris-Abuse-TLDS, Safelist-Chris-Black-TLDS
tatar!	Safelist-Chris-Suspicious-TLDS
tattoo!	Safelist-Chris-Abuse-TLDS, Safelist-Chris-Suspicious-TLDS, Safelist-SpamHaus
tax!	Safelist-Chris-Suspicious-TLDS, Safelist-Donuts
taxi!	Safelist-Chris-Suspicious-TLDS, Safelist-Donuts
tc!	Safelist-Chris-Abuse-TLDS
te!	Safelist-Chris-Abuse-TLDS, Safelist-Chris-Black-TLDS, Safelist-OpenNic
team!	Safelist-Chris-Abuse-TLDS, Safelist-Donuts
tech!	Safelist-Chris-Abuse-TLDS, Safelist-Chris-Black-TLDS
technologies!	Safelist-Chris-Abuse-TLDS
technology!	Safelist-Chris-Abuse-TLDS, Safelist-Chris-Black-TLDS, Safelist-Donuts
tel!	Safelist-Chris-Abuse-TLDS, Safelist-Chris-Black-TLDS
tennis!	Safelist-Chris-Suspicious-TLDS, Safelist-Donuts
test!	Safelist-Chris-Abuse-TLDS, Safelist-Chris-Black-TLDS
text!	Safelist-Chris-Abuse-TLDS, Safelist-Chris-Black-TLDS
tf!	Safelist-Chris-Abuse-TLDS
th!	Safelist-Chris-Abuse-TLDS, Safelist-Chris-Black-TLDS
theater!	Safelist-Chris-Suspicious-TLDS, Safelist-Donuts
theatre!	Safelist-Chris-Suspicious-TLDS
ti!	Safelist-Chris-Abuse-TLDS, Safelist-Chris-Black-TLDS, Safelist-OpenNic
tickets!	Safelist-Chris-Suspicious-TLDS
tienda!	Safelist-Chris-Suspicious-TLDS, Safelist-Donuts
tips!	Safelist-Chris-Suspicious-TLDS, Safelist-Donuts
tires!	Safelist-Chris-Suspicious-TLDS, Safelist-Donuts
tk!	Safelist-Chris-Abuse-TLDS, Safelist-Chris-Black-TLDS, Safelist-Dotless
tld!	Safelist-Chris-Abuse-TLDS, Safelist-Chris-Black-TLDS
tmall!	Safelist-Donuts
today!	Safelist-Chris-Abuse-TLDS, Safelist-Chris-Black-TLDS, Safelist-Donuts
tokyo!	Safelist-Chris-Abuse-TLDS, Safelist-Chris-Black-TLDS
tomorrow!	Safelist-Chris-Abuse-TLDS
tools!	Safelist-Chris-Abuse-TLDS, Safelist-Chris-Black-TLDS, Safelist-Donuts
top!	Safelist-Include, Safelist-Chris-Abuse-TLDS, Safelist-Chris-Black-TLDS, Safelist-SpamHaus
tor!	Safelist-Chris-Abuse-TLDS, Safelist-Chris-Black-TLDS
toronto!	Safelist-Chris-Abuse-TLDS
total!	Safelist-Chris-Suspicious-TLDS
totolink!	Safelist-Chris-Abuse-TLDS
tours!	Safelist-Chris-Suspicious-TLDS, Safelist-Donuts
town!	Safelist-Chris-Suspicious-TLDS, Safelist-Donuts
toys!	Safelist-Chris-Suspicious-TLDS, Safelist-Donuts
tp!	Safelist-Chris-Abuse-TLDS
tr!	Safelist-Chris-Abuse-TLDS, Safelist-Chris-Black-TLDS
trade!	Safelist-Chris-Abuse-TLDS, Safelist-Chris-Black-TLDS, Safelist-SpamHaus
trading!	Safelist-Chris-Abuse-TLDS, Safelist-Chris-Black-TLDS, Safelist-Donuts
training!	Safelist-Chris-Abuse-TLDS, Safelist-Chris-Black-TLDS, Safelist-Donuts
travel!	Safelist-Chris-Suspicious-TLDS, Safelist-Donuts
travelers!	Safelist-Chris-Suspicious-TLDS
travelersinsurance!	Safelist-Chris-Suspicious-TLDS
trust!	Safelist-Chris-Suspicious-TLDS
tt!	Safelist-Chris-Abuse-TLDS
tube!	Safelist-Chris-Abuse-TLDS, Safelist-Chris-Black-TLDS
tunes!	Safelist-Chris-Suspicious-TLDS
tushu!	Safelist-Chris-Abuse-TLDS
tw!	Safelist-Chris-Abuse-TLDS, Safelist-Chris-Black-TLDS
txt!	Safelist-Chris-Abuse-TLDS, Safelist-Chris-Black-TLDS
ua!	Safelist-Chris-Abuse-TLDS, Safelist-Chris-Black-TLDS
um!	Safelist-Chris-Abuse-TLDS
unassigned!	Safelist-Chris-Abuse-TLDS
unicom!	Safelist-Chris-Abuse-TLDS
university!	Safelist-Chris-Suspicious-TLDS, Safelist-Donuts
unknown!	Safelist-Chris-Abuse-TLDS
unknowndomain!	Safelist-Chris-Abuse-TLDS
uno!	Safelist-Chris-Abuse-TLDS, Safelist-Chris-Suspicious-TLDS, Safelist-SpamHaus
uol!	Safelist-Chris-Suspicious-TLDS
uranus!	Safelist-Chris-Abuse-TLDS
url!	Safelist-Chris-Abuse-TLDS, Safelist-Chris-Black-TLDS
us!	Safelist-Chris-Abuse-TLDS, Safelist-Chris-Black-TLDS
uu!	Safelist-Chris-Abuse-TLDS, Safelist-Chris-Black-TLDS, Safelist-OpenNic
uucp!	Safelist-Chris-Abuse-TLDS
uz!	Safelist-Dotless
vacations!	Safelist-Chris-Suspicious-TLDS, Safelist-Donuts
vegas!	Safelist-Chris-Suspicious-TLDS
ventures!	Safelist-Chris-Suspicious-TLDS, Safelist-Donuts
venus!	Safelist-Chris-Abuse-TLDS
vera!	Safelist-Chris-Abuse-TLDS
versicherung!	Safelist-Chris-Suspicious-TLDS
version!	Safelist-Chris-Abuse-TLDS
vet!	Safelist-Chris-Abuse-TLDS, Safelist-Donuts
viajes!	Safelist-Chris-Abuse-TLDS, Safelist-Chris-Suspicious-TLDS, Safelist-Donuts
video!	Safelist-Chris-Abuse-TLDS, Safelist-Donuts
vig!	Safelist-Chris-Suspicious-TLDS
viking!	Safelist-Chris-Suspicious-TLDS
villas!	Safelist-Chris-Suspicious-TLDS, Safelist-Donuts
vin!	Safelist-Chris-Suspicious-TLDS, Safelist-Donuts
vip!	Safelist-Chris-Abuse-TLDS, Safelist-Chris-Black-TLDS
virtualmin!	Safelist-Chris-Abuse-TLDS
virtus!	Safelist-Chris-Abuse-TLDS
vision!	Safelist-Chris-Suspicious-TLDS, Safelist-Donuts
vn!	Safelist-Chris-Abuse-TLDS, Safelist-Chris-Black-TLDS
vodka!	Safelist-Chris-Abuse-TLDS, Safelist-Chris-Black-TLDS
vote!	Safelist-Chris-Suspicious-TLDS, Safelist-Donuts
voting!	Safelist-Chris-Suspicious-TLDS
voto!	Safelist-Chris-Abuse-TLDS, Safelist-Chris-Suspicious-TLDS, Safelist-Donuts
voyage!	Safelist-Chris-Suspicious-TLDS, Safelist-Donuts
wallet!	Safelist-Include
wang!	Safelist-Chris-Abuse-TLDS, Safelist-Chris-Black-TLDS
wanggou!	Safelist-Chris-Abuse-TLDS
watch!	Safelist-Chris-Suspicious-TLDS, Safelist-Donuts
watches!	Safelist-Chris-Suspicious-TLDS, Safelist-Donuts
weather!	Safelist-Chris-Abuse-TLDS, Safelist-Chris-Suspicious-TLDS
web!	Safelist-Chris-Abuse-TLDS, Safelist-Chris-Black-TLDS
webcam!	Safelist-Chris-Abuse-TLDS, Safelist-Chris-Black-TLDS
webcamsex!	Safelist-Chris-Abuse-TLDS, Safelist-Chris-Black-TLDS
webp!	Safelist-Chris-Abuse-TLDS
website!	Safelist-Chris-Abuse-TLDS, Safelist-Chris-Black-TLDS
wed!	Safelist-Chris-Suspicious-TLDS
wedding!	Safelist-Chris-Suspicious-TLDS
weibo!	Safelist-Chris-Abuse-TLDS
wf!	Safelist-Chris-Abuse-TLDS, Safelist-SpamHaus
whatever!	Safelist-Chris-Abuse-TLDS
white!	Safelist-Chris-Abuse-TLDS, Safelist-Chris-Black-TLDS
whoswho!	Safelist-Chris-Suspicious-TLDS
wiki!	Safelist-Chris-Abuse-TLDS, Safelist-Chris-Black-TLDS
williamhill!	Safelist-Chris-Abuse-TLDS, Safelist-Chris-Black-TLDS
win!	Safelist-Chris-Abuse-TLDS, Safelist-Chris-Black-TLDS
windows!	Safelist-Chris-Suspicious-TLDS
wine!	Safelist-Chris-Suspicious-TLDS, Safelist-Donuts
winners!	Safelist-Chris-Suspicious-TLDS
wirelessap!	Safelist-Chris-Abuse-TLDS
work!	Safelist-Chris-Abuse-TLDS, Safelist-Chris-Black-TLDS
workgroup!	Safelist-Chris-Abuse-TLDS, Safelist-Chris-Black-TLDS
works!	Safelist-Chris-Abuse-TLDS, Safelist-Chris-Black-TLDS, Safelist-Donuts
world!	Safelist-Chris-Abuse-TLDS, Safelist-Chris-Black-TLDS, Safelist-Donuts
wow!	Safelist-Chris-Suspicious-TLDS
wpad!	Safelist-Chris-Abuse-TLDS, Safelist-Chris-Black-TLDS
ws!	Safelist-Chris-Abuse-TLDS, Safelist-Dotless
wss!	Safelist-Chris-Abuse-TLDS, Safelist-Chris-Black-TLDS
wtf!	Safelist-Chris-Abuse-TLDS, Safelist-Chris-Black-TLDS, Safelist-Donuts
www!	Safelist-Chris-Abuse-TLDS, Safelist-Chris-Black-TLDS
xhtm!	Safelist-Chris-Abuse-TLDS
xhtml!	Safelist-Chris-Abuse-TLDS, Safelist-Chris-Black-TLDS
xihuan!	Safelist-Chris-Abuse-TLDS
xin!	Safelist-Chris-Abuse-TLDS, Safelist-Chris-Black-TLDS
xls!	Safelist-Chris-Abuse-TLDS, Safelist-Chris-Black-TLDS
xlsx!	Safelist-Chris-Abuse-TLDS, Safelist-Chris-Black-TLDS
xmas!	Safelist-Chris-Abuse-TLDS, Safelist-Chris-Black-TLDS
xml!	Safelist-Chris-Abuse-TLDS, Safelist-Chris-Black-TLDS
xn--0zwm56d!	Safelist-Test
xn--11b4c3d!	Safelist-Chris-Abuse-TLDS
xn--11b5bs3a9aj6g!	Safelist-Test
xn--1ck2e1b!	Safelist-Chris-Abuse-TLDS
xn--1qqw23a!	Safelist-Chris-Abuse-TLDS
xn--2scrj9c!	Safelist-Chris-Abuse-TLDS, Safelist-Chris-Black-TLDS, Safelist-SpamHaus
xn--30rr7y!	Safelist-Chris-Abuse-TLDS
xn--3bst00m!	Safelist-Chris-Abuse-TLDS
xn--3ds443g!	Safelist-Chris-Abuse-TLDS
xn--3e0b707e!	Safelist-Chris-Abuse-TLDS, Safelist-SpamHaus
xn--3hcrj9c!	Safelist-Chris-Abuse-TLDS, Safelist-Chris-Black-TLDS
xn--3oq18vl8pn36a!	Safelist-Chris-Abuse-TLDS
xn--3pxu8k!	Safelist-Chris-Abuse-TLDS
xn--42c2d9a!	Safelist-Chris-Abuse-TLDS
xn--45br5cyl!	Safelist-Chris-Abuse-TLDS, Safelist-Chris-Black-TLDS
xn--45brj9c!	Safelist-Chris-Abuse-TLDS
xn--45q11c!	Safelist-Chris-Abuse-TLDS
xn--4dbrk0ce!	Safelist-Chris-Abuse-TLDS
xn--4gbrim!	Safelist-Chris-Abuse-TLDS
xn--54b7fta0cc!	Safelist-Chris-Abuse-TLDS
xn--55qw42g!	Safelist-Chris-Abuse-TLDS
xn--55qx5d!	Safelist-Chris-Abuse-TLDS
xn--5su34j936bgsg!	Safelist-Chris-Abuse-TLDS
xn--5tzm5g!	Safelist-Chris-Abuse-TLDS, Safelist-SpamHaus
xn--6frz82g!	Safelist-Chris-Abuse-TLDS
xn--6qq986b3xl!	Safelist-Chris-Abuse-TLDS
xn--80adxhks!	Safelist-Chris-Abuse-TLDS
xn--80akhbyknj4f!	Safelist-Test
xn--80ao21a!	Safelist-Chris-Abuse-TLDS
xn--80aqecdr1a!	Safelist-Chris-Abuse-TLDS
xn--80asehdb!	Safelist-Chris-Abuse-TLDS
xn--80aswg!	Safelist-Chris-Abuse-TLDS
xn--8y0a063a!	Safelist-Chris-Abuse-TLDS
xn--90a3ac!	Safelist-Chris-Abuse-TLDS
xn--90ae!	Safelist-Chris-Abuse-TLDS
xn--90ais!	Safelist-Chris-Abuse-TLDS
xn--9dbq2a!	Safelist-Chris-Abuse-TLDS
xn--9et52u!	Safelist-Chris-Abuse-TLDS
xn--9krt00a!	Safelist-Chris-Abuse-TLDS
xn--9t4b11yi5a!	Safelist-Test
xn--b4w605ferd!	Safelist-Chris-Abuse-TLDS
xn--bck1b9a5dre4c!	Safelist-Chris-Abuse-TLDS
xn--c1avg!	Safelist-Chris-Abuse-TLDS
xn--c2br7g!	Safelist-Chris-Abuse-TLDS
xn--cck2b3b!	Safelist-Chris-Abuse-TLDS
xn--cckwcxetd!	Safelist-Chris-Abuse-TLDS
xn--cg4bki!	Safelist-Chris-Abuse-TLDS
xn--clchc0ea0b2g2a9gcd!	Safelist-Chris-Abuse-TLDS
xn--czr694b!	Safelist-Chris-Abuse-TLDS
xn--czrs0t!	Safelist-Chris-Abuse-TLDS
xn--czru2d!	Safelist-Chris-Abuse-TLDS
xn--d1acj3b!	Safelist-Chris-Abuse-TLDS
xn--d1alf!	Safelist-Chris-Abuse-TLDS
xn--deba0ad!	Safelist-Test
xn--e1a4c!	Safelist-Chris-Abuse-TLDS
xn--eckvdtc9d!	Safelist-Chris-Abuse-TLDS
xn--efvy88h!	Safelist-Chris-Abuse-TLDS
xn--estv75g!	Safelist-Chris-Abuse-TLDS
xn--fct429k!	Safelist-Chris-Abuse-TLDS
xn--fhbei!	Safelist-Chris-Abuse-TLDS
xn--fiq228c5hs!	Safelist-Chris-Abuse-TLDS
xn--fiq64b!	Safelist-Chris-Abuse-TLDS
xn--fiqs8s!	Safelist-Chris-Abuse-TLDS
xn--fiqz9s!	Safelist-Chris-Abuse-TLDS
xn--fjq720a!	Safelist-Chris-Abuse-TLDS, Safelist-SpamHaus
xn--flw351e!	Safelist-Chris-Abuse-TLDS
xn--fpcrj9c3d!	Safelist-Chris-Abuse-TLDS
xn--fzc2c9e2c!	Safelist-Chris-Abuse-TLDS
xn--fzys8d69uvgm!	Safelist-Chris-Abuse-TLDS
xn--g2xx48c!	Safelist-Chris-Abuse-TLDS
xn--g6w251d!	Safelist-Test
xn--gckr3f0f!	Safelist-Chris-Abuse-TLDS
xn--gecrj9c!	Safelist-Chris-Abuse-TLDS
xn--gk3at1e!	Safelist-Chris-Abuse-TLDS
xn--h2breg3eve!	Safelist-Chris-Abuse-TLDS, Safelist-Chris-Black-TLDS
xn--h2brj9c!	Safelist-Chris-Abuse-TLDS
xn--h2brj9c8c!	Safelist-Chris-Abuse-TLDS, Safelist-Chris-Black-TLDS, Safelist-SpamHaus
xn--hgbk6aj7f53bba!	Safelist-Test
xn--hlcj6aya9esc7a!	Safelist-Test
xn--hxt814e!	Safelist-Chris-Abuse-TLDS
xn--i1b6b1a6a2e!	Safelist-Chris-Abuse-TLDS
xn--imr513n!	Safelist-Chris-Abuse-TLDS
xn--io0a7i!	Safelist-Chris-Abuse-TLDS
xn--j1aef!	Safelist-Chris-Abuse-TLDS
xn--j1amh!	Safelist-Chris-Abuse-TLDS, Safelist-Chris-Black-TLDS
xn--j6w193g!	Safelist-Chris-Abuse-TLDS
xn--jlq480n2rg!	Safelist-Chris-Abuse-TLDS
xn--jlq61u9w7b!	Safelist-Chris-Abuse-TLDS
xn--jvr189m!	Safelist-Chris-Abuse-TLDS
xn--jxalpdlp!	Safelist-Test
xn--kcrx77d1x4a!	Safelist-Chris-Abuse-TLDS
xn--kgbechtv!	Safelist-Test
xn--kprw13d!	Safelist-Chris-Abuse-TLDS
xn--kpry57d!	Safelist-Chris-Abuse-TLDS
xn--kput3i!	Safelist-Chris-Abuse-TLDS
xn--l1acc!	Safelist-Chris-Abuse-TLDS
xn--lgbbat1ad8j!	Safelist-Chris-Abuse-TLDS
xn--mgb9awbf!	Safelist-Chris-Abuse-TLDS
xn--mgba3a3ejt!	Safelist-Chris-Abuse-TLDS
xn--mgba3a4f16a!	Safelist-Chris-Abuse-TLDS
xn--mgba3a4fra!	Safelist-Chris-Abuse-TLDS
xn--mgba7c0bbn0a!	Safelist-Chris-Abuse-TLDS
xn--mgbaakc7dvf!	Safelist-Chris-Abuse-TLDS
xn--mgbaam7a8h!	Safelist-Chris-Abuse-TLDS
xn--mgbab2bd!	Safelist-Chris-Abuse-TLDS
xn--mgbah1a3hjkrd!	Safelist-Chris-Abuse-TLDS
xn--mgbai9a5eva00b!	Safelist-Chris-Abuse-TLDS
xn--mgbai9azgqp6j!	Safelist-Chris-Abuse-TLDS
xn--mgbayh7gpa!	Safelist-Chris-Abuse-TLDS
xn--mgbbh1a!	Safelist-Chris-Abuse-TLDS, Safelist-Chris-Black-TLDS
xn--mgbbh1a71e!	Safelist-Chris-Abuse-TLDS
xn--mgbc0a9azcg!	Safelist-Chris-Abuse-TLDS
xn--mgbca7dzdo!	Safelist-Chris-Abuse-TLDS
xn--mgbcpq6gpa1a!	Safelist-Chris-Abuse-TLDS
xn--mgberp4a5d4ar!	Safelist-Chris-Abuse-TLDS
xn--mgbgu82a!	Safelist-Chris-Abuse-TLDS, Safelist-Chris-Black-TLDS
xn--mgbi4ecexp!	Safelist-Chris-Abuse-TLDS
xn--mgbpl2fh!	Safelist-Chris-Abuse-TLDS
xn--mgbt3dhd!	Safelist-Chris-Abuse-TLDS
xn--mgbtx2b!	Safelist-Chris-Abuse-TLDS
xn--mgbx4cd0ab!	Safelist-Chris-Abuse-TLDS
xn--mix082f!	Safelist-Chris-Abuse-TLDS
xn--mix891f!	Safelist-Chris-Abuse-TLDS
xn--mk1bu44c!	Safelist-Chris-Abuse-TLDS, Safelist-SpamHaus
xn--mxtq1m!	Safelist-Chris-Abuse-TLDS
xn--ngbc5azd!	Safelist-Chris-Abuse-TLDS
xn--ngbe9e0a!	Safelist-Chris-Abuse-TLDS
xn--ngbrx!	Safelist-Chris-Abuse-TLDS
xn--nnx388a!	Safelist-Chris-Abuse-TLDS
xn--node!	Safelist-Chris-Abuse-TLDS
xn--nqv7f!	Safelist-Chris-Abuse-TLDS, Safelist-Chris-Black-TLDS
xn--nqv7fs00ema!	Safelist-Chris-Abuse-TLDS
xn--nyqy26a!	Safelist-Chris-Abuse-TLDS
xn--o3cw4h!	Safelist-Chris-Abuse-TLDS
xn--ogbpf8fl!	Safelist-Chris-Abuse-TLDS
xn--otu796d!	Safelist-Chris-Abuse-TLDS
xn--p1acf!	Safelist-Chris-Abuse-TLDS
xn--p1ai!	Safelist-Chris-Abuse-TLDS, Safelist-Chris-Black-TLDS
xn--pgbs0dh!	Safelist-Chris-Abuse-TLDS
xn--pssy2u!	Safelist-Chris-Abuse-TLDS
xn--q7ce6a!	Safelist-Chris-Abuse-TLDS
xn--q9jyb4c!	Safelist-Chris-Abuse-TLDS, Safelist-SpamHaus
xn--qcka1pmc!	Safelist-Chris-Abuse-TLDS
xn--qxa6a!	Safelist-Chris-Abuse-TLDS
xn--qxam!	Safelist-Chris-Abuse-TLDS
xn--rhqv96g!	Safelist-Chris-Abuse-TLDS, Safelist-SpamHaus
xn--rovu88b!	Safelist-Chris-Abuse-TLDS
xn--rvc1e0am3e!	Safelist-Chris-Abuse-TLDS, Safelist-Chris-Black-TLDS
xn--s9brj9c!	Safelist-Chris-Abuse-TLDS, Safelist-SpamHaus
xn--ses554g!	Safelist-Chris-Abuse-TLDS
xn--t60b56a!	Safelist-Chris-Abuse-TLDS, Safelist-SpamHaus
xn--tckwe!	Safelist-Chris-Abuse-TLDS, Safelist-Chris-Black-TLDS, Safelist-SpamHaus
xn--tiq49xqyj!	Safelist-Chris-Abuse-TLDS
xn--unup4y!	Safelist-Chris-Abuse-TLDS, Safelist-SpamHaus
xn--vcst06ab2a!	Safelist-Chris-Abuse-TLDS
xn--vermgensberater-ctb!	Safelist-Chris-Abuse-TLDS
xn--vermgensberatung-pwb!	Safelist-Chris-Abuse-TLDS
xn--vhquv!	Safelist-Chris-Abuse-TLDS
xn--vuq861b!	Safelist-Chris-Abuse-TLDS
xn--w4r85el8fhu5dnra!	Safelist-Chris-Abuse-TLDS
xn--w4rs40l!	Safelist-Chris-Abuse-TLDS
xn--wgbh1c!	Safelist-Chris-Abuse-TLDS
xn--wgbl6a!	Safelist-Chris-Abuse-TLDS
xn--wgv71a!	Safelist-Chris-Abuse-TLDS
xn--xhq521b!	Safelist-Chris-Abuse-TLDS, Safelist-SpamHaus
xn--xkc2al3hye2a!	Safelist-Chris-Abuse-TLDS
xn--xkc2dl3a5ee0h!	Safelist-Chris-Abuse-TLDS
xn--y9a3aq!	Safelist-Chris-Abuse-TLDS
xn--yfro4i67o!	Safelist-Chris-Abuse-TLDS
xn--ygbi2ammx!	Safelist-Chris-Abuse-TLDS
xn--zckzah!	Safelist-Test
xn--zfr164b!	Safelist-Chris-Abuse-TLDS
xxx!	Safelist-Chris-Abuse-TLDS, Safelist-Chris-Black-TLDS
xyz!	Safelist-Chris-Abuse-TLDS, Safelist-Chris-Black-TLDS, Safelist-SpamHaus
yachts!	Safelist-Chris-Abuse-TLDS, Safelist-Chris-Suspicious-TLDS, Safelist-SpamHaus
yamaxun!	Safelist-Chris-Suspicious-TLDS
yandex!	Safelist-Chris-Abuse-TLDS, Safelist-Chris-Black-TLDS
yaws!	Safelist-Chris-Abuse-TLDS, Safelist-Chris-Black-TLDS
yd!	Safelist-Chris-Abuse-TLDS
yesterday!	Safelist-Chris-Abuse-TLDS
ykp!	Safelist-Chris-Abuse-TLDS
yodobashi!	Safelist-Chris-Suspicious-TLDS
yoga!	Safelist-Chris-Suspicious-TLDS
yokohama!	Safelist-Chris-Abuse-TLDS, Safelist-Chris-Black-TLDS
you!	Safelist-Chris-Abuse-TLDS, Safelist-Chris-Suspicious-TLDS, Safelist-SpamHaus
yu!	Safelist-Chris-Abuse-TLDS
yun!	Safelist-Chris-Suspicious-TLDS
yxdomain!	Safelist-Chris-Abuse-TLDS, Safelist-Chris-Black-TLDS
yxrrset!	Safelist-Chris-Abuse-TLDS, Safelist-Chris-Black-TLDS
zero!	Safelist-Chris-Suspicious-TLDS
zervdns!	Safelist-Chris-Abuse-TLDS
zhongguo!	Safelist-Chris-Abuse-TLDS
zil!	Safelist-Include, Safelist-Chris-Abuse-TLDS, Safelist-Chris-Black-TLDS
zip!	Safelist-Chris-Abuse-TLDS, Safelist-Chris-Black-TLDS
zone!	Safelist-Chris-Abuse-TLDS, Safelist-Chris-Black-TLDS, Safelist-Donuts, Safelist-SpamHaus
zr!	Safelist-Chris-Abuse-TLDS
zw!	Safelist-Chris-Abuse-TLDS
### BLACKLIST REGEXES ###
### BLACKLIST DOMAINS ###
-	Chris-Abuse-TLDS
0	Chris-Abuse-TLDS
1	Chris-Abuse-TLDS
537z	Chris-Abuse-TLDS
6r	Chris-Abuse-TLDS
888	Include
a	Chris-Abuse-TLDS
cp6	Chris-Abuse-TLDS
digicom-adsl	Chris-Abuse-TLDS
edns0	Chris-Abuse-TLDS
eth0	Chris-Abuse-TLDS
eth1	Chris-Abuse-TLDS
i2p	Chris-Black-TLDS
ip6-allnodes	Chris-Black-TLDS
ip6-allrouters	Chris-Black-TLDS
ip6-localhost	Chris-Black-TLDS
ip6-localnet	Chris-Black-TLDS
ip6-loopback	Chris-Black-TLDS
ip6-mcastprefix	Chris-Black-TLDS
jehovax0	Chris-Abuse-TLDS
jehovax1	Chris-Abuse-TLDS
k12	Chris-Black-TLDS
lan1	Chris-Abuse-TLDS
lan2	Chris-Abuse-TLDS
localdomain4	Chris-Black-TLDS
localdomain6	Chris-Black-TLDS
localhost4	Chris-Black-TLDS
localhost6	Chris-Black-TLDS
mp3	Chris-Abuse-TLDS
mp4	Chris-Abuse-TLDS
o	OpenNic
p2p	Chris-Black-TLDS
php3	Chris-Black-TLDS
php4	Chris-Black-TLDS
qencode-encoder-cd22de30229b11ec9a3d62b78d0049ec	Chris-Abuse-TLDS
rac2v1a	Chris-Abuse-TLDS
reverse-dns	Chris-Abuse-TLDS
wlan_ap	Chris-Abuse-TLDS
x	Include
z	Chris-Abuse-TLDS
zghjccbob3n0	Chris-Abuse-TLDS
### BLACKLIST ASN ###
### BLACKLIST IPv4 ###
### BLACKLIST IPv6 ###
### BLACKLIST EOF ###
