# ONLY USE FOR REFERENCE!
asus	# Invalid-TLD-Sinfonietta-Porn
bit	# Invalid-TLD-KidSaf
cim	# Invalid-TLD-Sinfonietta-Porn
comde	# Invalid-TLD-Sinfonietta-Porn
comhome	# Invalid-TLD-Hagezi-Gambling
comj	# Invalid-TLD-Mhhakim
desixxxsex	# Invalid-TLD-ADGH-Porn
home	# Invalid-TLD-Sinfonietta-Porn
instit	# Invalid-TLD-ADGH-Porn
koko	# Invalid-TLD-KidSaf
lan	# Invalid-TLD-Mhhakim
lusecurity	# Invalid-TLD-Mhhakim
mobil	# Invalid-TLD-ADGH-Porn
nlnichecouple	# Invalid-TLD-ADGH-Porn
onilne	# Invalid-TLD-ADGH-Gamble
onion	# Invalid-TLD-KidSaf
orgdojin	# Invalid-TLD-Mhhakim
pic	# Invalid-TLD-ADGH-Porn
skinde	# Invalid-TLD-Sinfonietta-Porn
som	# Invalid-TLD-Sinfonietta-Porn
totolink	# Invalid-TLD-Sinfonietta-Porn
xx	# Invalid-TLD-Mhhakim
xy	# Invalid-TLD-ADGH-Porn
