############################################
### ACCOMPLIST GENERATED BLACKLIST       ###
### Version: 1732684194                  ###
### Chris Buijs                          ###
### https://github.com/cbuijs/accomplist ###
############################################

### SAFELIST DOMAINS ###
### BLACKLIST REGEXES ###
### BLACKLIST DOMAINS ###
animehub.ac	Video
cmovies.ac	Video
kissanime.ac	Video, Torrent-Websites
kisscartoon.ac	Torrent-Websites
myflixer.ac	Video
openloadmovies.ac	Video
primewire.ac	Video
series9.ac	Video
soap2day.ac	Video
sockshare.ac	Video
putlocker.actor	Video
123movies.ag	Video
extratorrent.ag	Torrent-Websites
eztv.ag	Torrent-Websites
lookmovie.ag	Video, Torrent-Websites
projectfreetv.ag	Video
tvbox.ag	Torrent-Websites
yesmovies.ag	Video
yts.ag	Torrent-Websites
yts.ai	Torrent-Websites
file.al	FileHosting
1337x.am	Torrent-Websites
bittorrent.am	Torrent-Websites
ibit.am	Torrent-Websites
kat.am	Torrent-Websites
putlockers.am	Video
riper.am	Torrent-Websites
yts.am	Torrent-Websites
1337x.app	Torrent-Websites
aostv.app	Video
fmoviestv.app	Video
isohunt.app	Torrent-Websites
losmovies.app	Video
novatv.app	Video
popcorntime.app	Torrent-Clients
solarmovie.app	Video
torrentkitty.app	Torrent-Websites
123movies.archi	Video
123movies.army	Video
aaa.army	Torrent-Trackers
tracker.army	Torrent-Trackers
ahoytpb.art	Torrent-Websites
boatmy.art	Torrent-Websites
indiaboat.art	Torrent-Websites
lookmovie.art	Video
proxtpb.art	Torrent-Websites
proxy247.art	Torrent-Websites
tpbpiratebaai.art	Torrent-Websites
123movies.as	Video
bdupload.asia	FileHosting
limetorrents.asia	Torrent-Websites
thepiratebay.asia	Torrent-Websites
limetorrents.at	Torrent-Websites
xbox.udp.at	Torrent-Websites
easy-movie.com.au	Video
fmovies.baby	Video
putlockers.bar	Video
thepiratebay.bar	Torrent-Websites
unblocked.bar	Proxies
crickfree.be	Video
cytu.be	Video
ettv.be	Torrent-Websites
tpbmirror.be	Torrent-Websites
watchseries-online.be	Video
mamahd.best	Video
netu.best	FileHosting
softwarez.best	Warez
myflixer.bet	Video
tracker.zum.bi	Torrent-Trackers
btkitty.bid	Torrent-Websites
mkvcage.bid	Video
123movies.bio	Video
animeflv.biz	Video
europix.biz	Video
filmesviatorrents.biz	Torrent-Websites
filmyhd.biz	Video
flixgo.biz	Video
layarkacaxxi.biz	Video
t.overflow.biz	Torrent-Trackers
soap2day.biz	Video
thepiratefilmestorrent.biz	Torrent-Websites
tpb.biz	Torrent-Websites
vmovie.biz	Video
123movie.blog	Video
pelisplus.blog	Video
aruacfilmes.com.br	Torrent-Trackers
1337x.buzz	Torrent-Websites
5movies.buzz	Video
coolmoviezone.buzz	Video
freemovies.buzz	Video
limetorrents.buzz	Torrent-Websites
lookmovie.buzz	Video
primewire.buzz	Video
rarbg.buzz	Torrent-Websites
thepiratebay0.buzz	Torrent-Websites
thoptvofficial.buzz	Video
unblckd.buzz	Torrent-Websites
jsb.by	Torrent-Trackers
torr.by	Torrent-Websites
torrent.by	Torrent-Websites
cmovieshd.bz	Video, Torrent-Websites
oxtorrent.bz	Torrent-Websites
proxybay.bz	Torrent-Websites
putlockers.bz	Video
tracker.theempire.bz	Torrent-Trackers
thegeeks.bz	Torrent-Trackers
theoccult.bz	Torrent-Trackers
theplace.bz	Torrent-Trackers
thevault.bz	Torrent-Trackers
tracker.bz	Torrent-Trackers
123movies4u.ca	Video
digitalmusicians.ca	Torrent-Websites
unblockit.ca	Proxies
upawg.ca	Torrent-Websites
movies.zsw.ca	Torrent-Trackers
fmovies.cafe	Video
gophie.cam	Video
songslover.cam	Audio
thepiratebay.cam	Torrent-Websites
losmovies.mrunblock.casa	Video
unblocked.casa	Proxies
nyaa.pantsu.cat	Torrent-Websites
sukebei.pantsu.cat	Torrent-Websites
123movie.cc	Video
12canime.cc	Video
1watch-free.cc	Video
7torrents.cc	Torrent-Websites
alpharatio.cc	Torrent-Websites
animeflv.cc	Video
animeid.cc	Video
animeram.cc	Video, Torrent-Websites
animesonline.cc	Video
beemp3.cc	Audio
btbbt.cc	Torrent-Websites
btdoor.cc	Torrent-Websites
cda-hd.cc	Video
crownbit.cc	Torrent-Websites
dopebox.cc	Video
emp3juices.cc	Audio
filman.cc	Video
filser.cc	Video
flashbit.cc	FileHosting
flixhd.cc	Video
freemp3.cc	Audio
freemp3juices.cc	Audio
gomovieshub.cc	Video
hdseries.cc	Video
hostcluster.cc	Video
hugefiles.cc	FileHosting
jetanime.cc	Video
limetorrents.cc	Torrent-Websites
limetorrentx.cc	Torrent-Websites
tp.m-team.cc	Torrent-Trackers
mac-torrents.cc	Torrent-Websites
movcr.cc	Torrent-Websites
movieminions.cc	Video
moviestowatch.cc	Video
moviewiz.cc	Video
mp3juices.cc	Audio
mp3juices3.cc	Audio
mp3juices4.cc	Audio
my-free-mp3.cc	Audio
nortex.cc	Video
nunuyy.cc	Video
oxtorrent.cc	Torrent-Websites
pirate-proxy.cc	Torrent-Websites
putlocker9.cc	Video
rarbg.cc	Torrent-Websites
s2dfree.cc	Video
seedr.cc	Torrent-Clients
smflix.cc	Video
solamovies.cc	Torrent-Websites
streamz.cc	Video
torrentz2.cc	Torrent-Websites
turbobit.cc	FileHosting
unblocker.cc	Proxies
vmovee.cc	Video
x265movies.cc	Video
yify-torrent.cc	Torrent-Websites
yifytorrent.cc	Torrent-Websites
ytmp3.cc	Audio
ytmp3juices.cc	Audio
zaluknij.cc	Video
zerion.cc	Video
myflixer.center	Video
piratebay.center	Torrent-Websites
tr.kxmp.cf	Torrent-Trackers
1337x.proxyserver.cf	Torrent-Websites
rarbg.proxyserver.cf	Torrent-Websites
pirate.cfd	Torrent-Websites
arenabg.ch	Torrent-Websites
extratorrents.ch	Torrent-Websites
eztv.ch	Torrent-Websites
goojara.ch	Video
icefilms.ch	Video
isohunt.ch	Torrent-Websites
kickass2.ch	Torrent-Websites
openloadmovies.ch	Video
popcorn-time.ch	Video, Torrent-Clients
prmovies.ch	Video
publictracker.ch	Torrent-Trackers
putlocker5movies.ch	Video
redacted.ch	Torrent-Websites
streamwat.ch	Video
torrentdownload.ch	Torrent-Websites
watchfreemovies.ch	Video
zer0day.ch	Torrent-Trackers
123movies.church	Video
torrentparadise.cl	Torrent-Websites
gomovies.click	Video
lookmovie.click	Video
thegeeks.click	Torrent-Websites
thepirateway.click	Torrent-Websites
tpbproxy.click	Torrent-Websites
lookmovie.clinic	Video
isra.cloud	FileHosting
musicpleer.cloud	Audio
pirateproxy.cloud	Torrent-Websites
sendit.cloud	FileHosting
123files.club	Video
batflixmovies.club	Video
bluetpb.club	Torrent-Websites
boatbay.club	Torrent-Websites
cpabien.club	Torrent-Websites
fast-torrent.club	Torrent-Websites
ffilms.club	Video
fost.club	Torrent-Websites
tracker.halfchub.club	Torrent-Trackers
i123movies.club	Video
indiaboat.club	Torrent-Websites
iplive.club	Video
movie123.club	Torrent-Websites
myporn.club	Torrent-Websites
piratetpb.club	Torrent-Websites
pornomen.club	Torrent-Websites
old.pubfilms.club	Video
putlocker-free.club	Video
showbox-apk.club	Video
streamwoop.club	Video
todori.club	Torrent-Websites
watchtvseries.unblckd.club	Torrent-Websites
vod78d.club	Video
ytsyify.club	Torrent-Websites
kickass.cm	Torrent-Websites
btann.cn	Torrent-Websites
share.camoe.cn	Torrent-Trackers
midea123.z-media.com.cn	Torrent-Trackers
torrent.org.cn	Torrent-Websites
techzero.cn	Torrent-Websites
torrents-nn.cn	Torrent-Trackers
allmoviesforyou.co	Video
alltorrents.co	Torrent-Websites
bemovies.co	Video
btomovie.co	Video
c1ne.co	Video
clicknupload.co	FileHosting
duboku.co	Video
f2movie.co	Video
f5movies.co	Video
fsharetv.co	Video
gamestorrent.co	Torrent-Websites
instamp3.co	Audio
katcr.co	Torrent-Websites
letsupload.co	FileHosting
limetorrents.co	Torrent-Websites
megaddl.co	Video, Torrent-Websites
megasearch.co	Video
mixdrop.co	FileHosting
movidy.co	Torrent-Websites
movie-forum.co	Video
movieforfree.co	Video
moviemagnet.co	Torrent-Websites
movies4u.co	Video
moviesgo.co	Video
movieshd.co	Video
movietorrent.co	Torrent-Websites
moviewetrust.co	Video
ln.mtahost.co	Torrent-Trackers
onionplay.co	Video
openload.co	FileHosting
oxtorrent.co	Torrent-Websites
pelis-plus.co	Video
pelispelis.co	Video
pelisplus.co	Video
putlockergo.co	Video
putlockers.co	Video
rulu.co	Video, Torrent-Websites
seehd.co	Torrent-Websites
seriesflix.co	Video
tracker.sloppyta.co	Torrent-Trackers
solarmovies.co	Video
tagmovies.co	Video
toros.co	Torrent-Websites
torrent-games.co	Torrent-Websites
torrentmovies.co	Torrent-Websites
ukpass.co	Torrent-Websites
uniteam.co	Torrent-Websites
vidcloud.co	FileHosting
videobin.co	FileHosting
watchasian.co	Torrent-Websites
watchmoviesnow.co	Video
webhd.co	Torrent-Websites
x265movies.co	Video, Warez
s.yoooo.co	Torrent-Websites
123movies.coach	Video
fmovies.coffee	Video
0123movies.com	Video
123-movies.com	Video
123hbo.com	Video
123hulu.com	Video
123movies.com	Video
123movies-apk.com	Video
123moviesbq.com	Video
123moviesget.com	Video
123movieshubz.com	Video
123moviestofree.com	Video
123movieswww.com	Video
123movietheater.com	Video
123tvnow.com	Video
12cmovies.com	Video
1337x.com	Torrent-Websites
141jav.com	Torrent-Websites
1fichier.com	FileHosting
1movietv.com	Video
2kandy.com	Torrent-Websites
365watchtv.com	Video
36dm.com	Torrent-Websites
bt.3dmgame.com	Torrent-Trackers, Torrent-Websites
480mkv.com	Torrent-Websites
480ptvshows.com	Video
4shared.com	FileHosting
54new.com	Torrent-Websites
87av.com	Torrent-Websites
8putlocker.com	Video
8wsm.com	Torrent-Websites
94hiphop.com	Audio
a8bt.com	Torrent-Websites
abrokegamer.com	Torrent-Websites
academymovies.com	Video
acechanime.com	Video
opentracker.acgnx.com	Torrent-Trackers
open.acgnxtracker.com	Torrent-Trackers
acgsou.com	Torrent-Websites
open.acgtracker.com	Torrent-Trackers
actvid.com	Video
add0n.com	Torrent-Websites
adit-hd.com	Video, Torrent-Websites, Warez
adorocinematorrent.com	Torrent-Websites
dht.aelitis.com	DHT-Bootstrap
ainiesta.com	Video
aiosearch.com	Torrent-Websites
akiba-online.com	Torrent-Websites
alabout.com	Torrent-Websites
all-animes.com	Torrent-Websites
alldebrid.com	FileHosting
allthebestfights.com	Video
alt-torrent.com	Torrent-Websites
alterupload.com	FileHosting
androidrookies.com	Torrent-Websites
anime.com	Video
anime-planet.com	Video
anime-sharing.com	Torrent-Websites
anime1.com	Video
animeblix.com	Video
animeclipse.com	Torrent-Websites
animedao.com	Video
animeflv1.com	Video
animeflvnet.com	Video
animehd47.com	Video
animekaizoku.com	Video, Torrent-Websites
animekayo.com	Torrent-Websites
animelon.com	Video
animemolecules.com	Video
animemoviespot.com	Video
animencodes.com	Torrent-Websites
animepahe.com	Video, Torrent-Websites
animepill.com	Video
animesim.com	Video
animesimple.com	Video
animixplay.com	Video
anirena.com	Torrent-Websites
aniwatcher.com	Video
academic-p2p.appspot.com	Torrent-Trackers
carbon-bonsai-621.appspot.com	Torrent-Trackers
arabp2p.com	Torrent-Websites
arenabg.com	Torrent-Websites
arrayanime.com	Video
at123movies.com	Video
audio-track.com	Audio
audiobookol.com	Torrent-Websites
aurora-raws.com	Torrent-Websites
avantabg.com	Torrent-Websites
badasstorrents.com	Torrent-Websites
baixarfilmetorrent.com	Torrent-Websites
tracker.beeimg.com	Torrent-Trackers
bellator.com	Video
bestfreestreaming.com	Torrent-Websites
bestkoditips.com	Video
bestsportstreaming.com	Torrent-Websites
bibtor.com	Torrent-Websites
bilibt.com	Torrent-Websites
bingemachine.com	Video
bit-hdtv.com	Torrent-Trackers
bitcomet.com	Torrent-Clients
bitlord.com	Torrent-Clients
bitseduce.com	Torrent-Trackers
bittorrent.com	Torrent-Websites
biztorrents.com	Torrent-Trackers, Torrent-Websites
blackboxrepack.com	Torrent-Websites
1337xtoindia.blogspot.com	Torrent-Websites
fullmuv.blogspot.com	Video
thepiratebaylk.blogspot.com	Torrent-Websites
bludv.com	Torrent-Websites
bms-hosxp.com	Torrent-Trackers
bnwmovies.com	Video
bobbialbano.com	Torrent-Trackers
boxopus.com	Torrent-Websites
tracker.bt-hash.com	Torrent-Trackers
tracker.bt4g.com	Torrent-Trackers
bt5000.com	Torrent-Websites
btafile.com	FileHosting
btbtt.com	Torrent-Websites
btbtw.com	Torrent-Websites
btdig.com	Torrent-Websites
btfensi.com	Torrent-Websites
btmet.com	Torrent-Websites
btnext.com	Torrent-Websites
cafehulu.com	Video, Torrent-Websites
cartoonhd.com	Video
cboku.com	Video
cgpeers.com	Torrent-Websites
chihiro-subs.com	Torrent-Websites
chronologicallylost.com	Torrent-Websites
cili001.com	Torrent-Websites
ciligou0.com	Torrent-Websites
cinebloom.com	Torrent-Websites
cinemaapk.com	Video
cinewhale.com	Video
city9x.com	Torrent-Websites
classiccinemaonline.com	Video
clipwatching.com	Video
club-mst3k.com	Torrent-Websites
cmoovies.com	Video
thepiratebay.co.com	Torrent-Websites
comandofilmetorrent.com	Torrent-Websites
comandohdtorrents.com	Torrent-Websites
comandotorrents.com	Torrent-Websites
convivea.com	Torrent-Websites
bt.cosxcos.com	Torrent-Websites
crackstreams.com	Video
crazy4tv.com	Video
fc2.crichd.com	Video
crocovid.com	Video
crotorrents.com	Torrent-Websites
cuevana2.com	Video
cuevanagt.com	Video
cxtvlive.com	Video
cyber12.com	Torrent-Websites
d-addicts.com	Torrent-Websites
damedesuyo.com	Torrent-Websites
danimados.com	Video
daveking.com	Torrent-Trackers
daxiv.com	Torrent-Websites
ddlsite.com	Warez
ddlspot.com	Warez
ddownload.com	FileHosting
open.demonii.com	Torrent-Trackers
desfichiers.com	FileHosting
exodus.desync.com	Torrent-Trackers
dfichiers.com	FileHosting
directoriowarez.com	Warez
dirtytorrents.com	Torrent-Websites
dirtywarez.com	Warez
divicast.com	Video
dl4free.com	FileHosting
valakas.rollo.dnsabr.com	Torrent-Trackers
doc-torrent.com	Torrent-Websites
dontorrents.com	Torrent-Websites
dosmovies.com	Video
dostomovies.com	Video
popcorn-time.en.downloadastro.com	Torrent-Clients
downloads-anymovies.com	Video
dramacoolfirst.com	Torrent-Websites
dramago.com	Torrent-Websites
dreamteamdownloads1.com	Warez
drumkitx.com	Torrent-Trackers
duboku.com	Video
earn4files.com	FileHosting
ebookbb.com	Warez
elamigos-games.com	Torrent-Websites
elitetorrent.com	Torrent-Websites
elitetorrent1.com	Torrent-Websites
eprojectfreetv.com	Video
eshiel.com	Video
ettvcentral.com	Torrent-Websites
ettvdl.com	Torrent-Websites
ettvproxies.com	Torrent-Websites
ettvtorrents.com	Torrent-Websites
extmatrix.com	FileHosting
extremlymtorrents.com	Torrent-Websites
eztv-torrent.com	Torrent-Websites
eztvmirror.com	Torrent-Websites
eztvproxy.com	Torrent-Websites
eztvstatus.com	Torrent-Websites
f1fullraces.com	Video
fboxtv.com	Video
file4safe.com	FileHosting
filechef.com	Video
filefactory.com	FileHosting
filelisting.com	Torrent-Websites
tracker.filemail.com	Torrent-Trackers
filerio.com	FileHosting
filespace.com	FileHosting
film1k.com	Torrent-Websites
filmheaven.com	Video
filmi-torrents.com	Torrent-Websites
filmobo.com	Video
filmrls.com	Torrent-Websites
filmsofts.com	Video
filmzie.com	Video
fireget.com	FileHosting
firesticktricks.com	Video
fl1x.com	Video
flacworld.com	Torrent-Websites
flixerrtv.com	Video
foggystream.com	Video
footybite.com	Video, Torrent-Websites
freeetextbooks.com	Torrent-Websites
freegogpcgames.com	Torrent-Websites
freeintertv.com	Video
freemocmovies.com	Video
freemovies360.com	Video
freemoviesee.com	Video
freestreams-live1.com	Video
god.freevar.com	Warez
rutorrent.frontline-mod.com	Torrent-Trackers
frostwire.com	Torrent-Clients
frozen-layer.com	Torrent-Websites
ftflix.com	Video
fullmatchfk.com	Video
fullmoviehd4k.com	Video
fullmoviesonlie.com	Video
game3rb.com	Torrent-Websites
gamestorrents.com	Torrent-Websites
genoanime.com	Video
getintopc.com	Warez
giga-down.com	FileHosting
gigapeta.com	FileHosting
gingadaddy.com	UseNet
god-games.com	Warez
gogo-stream.com	Video
goldenshara.com	Torrent-Websites
goloady.com	FileHosting
gomovies-online.com	Video
goodjobmedia.com	Torrent-Websites
graphicex.com	Warez
tracker.grepler.com	Torrent-Trackers
h2mp3.com	Audio
hanjutv2020.com	Video
haruhichan.com	Torrent-Websites
hd4fun.com	Video
hdc0ol.com	Warez
hdencode.com	Video, Torrent-Websites, Warez
hdlivemovies.com	Video
hdmovie2.com	Video
helltorrents.com	Torrent-Websites
henbt.com	Torrent-Websites
hentaisun.com	Torrent-Websites
trakx.herokuapp.com	Torrent-Trackers
hevcbay.com	Video, Torrent-Websites
hi10anime.com	Torrent-Websites
bt.hliang.com	Torrent-Trackers
hlscat.com	Video
hurawatch.com	Video
icefilms-info.com	Video
igg-games.com	Warez
ihavenotv.com	Video
imkmedia.com	Video
imovietube.com	Video
inclouddrive.com	FileHosting
tracker2.indowebster.com	Torrent-Trackers
iptorrents.com	Torrent-Websites
iraniantorrents.com	Torrent-Websites
irwarez.com	Warez
istream-it.com	Video
isubsmovies.com	Video
bbs.itzmx.com	Torrent-Websites
tracker1.itzmx.com	Torrent-Trackers
tracker2.itzmx.com	Torrent-Trackers
tracker3.itzmx.com	Torrent-Trackers
tracker4.itzmx.com	Torrent-Trackers
javbus.com	Torrent-Websites
javfeed.com	Torrent-Websites
javjunkies.com	Torrent-Websites
javlibrary.com	Torrent-Websites
jimmyr.com	Audio, Video
joytorrent.com	Torrent-Websites
jstorrent.com	Torrent-Clients
k2nblog.com	Audio
katfile.com	FileHosting
kawaiifu.com	Video
khinsider.com	Audio
open.kickasstracker.com	Torrent-Trackers
kingdom-leaks.com	Audio
kinkeadtech.com	Video
kinorun.com	Torrent-Trackers
klimtthemovie.com	Video
kodiapps.com	Video
lacraiatorrent.com	Torrent-Websites
ladresstina.com	Video
camera.lei001.com	Torrent-Trackers
limetor.com	Torrent-Websites
tvonline.liveschauen.com	Video
tracker01.loveapp.com	Torrent-Trackers
luckywarez.com	Warez
lumpysoft.com	Video
lunchflix.com	Video
m3u4u.com	Video
m4ufree.com	Video
m4uhd.com	Video
mac-torrents.com	Torrent-Websites
madeintorrent.com	Torrent-Websites
magnetdl.com	Torrent-Websites
bubu.mapfactor.com	Torrent-Trackers
masters-tb.com	Torrent-Trackers
down.mdiaload.com	FileHosting
me-4u.com	Audio
mechopirate.com	Warez
mediafire.com	FileHosting
megashara.com	Torrent-Websites
megasharesc.com	Video
mejortorrent.com	Torrent-Websites
mejortorrents1.com	Torrent-Websites
z.mercax.com	Torrent-Trackers
metal-tracker.com	Torrent-Websites
meusfilmestorrents.com	Torrent-Websites
mexashare.com	FileHosting
minionstream.com	Video
miobt.com	Torrent-Websites
mixfiend.com	Torrent-Trackers, Torrent-Websites
mkvcage.com	Video
mma-core.com	Video
mojobb.com	Warez
monoschinos.com	Video
morpheustvhd.com	Video
motivationalhacks.com	Video
moviejesus.com	Video
moviemaya.com	Video
movieorca.com	Video
movierot.com	Video
moviesbark.com	Video
moviesdvdr.com	Torrent-Websites
moviesfoundonline.com	Video
movieskiduniaa.com	Video
movieswbb.com	Video
mp3guild.com	Audio
mp3juicestv.com	Audio
mp4ba.com	Torrent-Websites
tracker.msm8916.com	Torrent-Trackers
musgle.com	Video
mvrls.com	Video
mxroom.com	Torrent-Websites
myflixer.com	Video
myfreemp3v.com	Audio
myunblock.com	Proxies
myustv.com	Video
nbabite.com	Video
nbafullhd.com	Video
nbahdreplay.com	Video
nboku.com	Video
new-primewire.com	Video
newsbin.com	UseNet
nextwarez.com	Warez
nflbite.com	Video
nflstreams100.com	Video
nitroflare.com	FileHosting
noobsubs.com	Video
novafile.com	FileHosting
novelas360.com	Video
t.nyaatracker.com	Torrent-Trackers
open.nyap2p.com	Torrent-Trackers
tracker.nyap2p.com	Torrent-Trackers
nzbindex.com	UseNet
nzbking.com	UseNet
nzbvortex.com	UseNet
oabt06.com	Torrent-Websites
oakmovies.com	Video, Torrent-Websites
okfreemovies.com	Video
olevod.com	Video
ologyyvidss.com	Video
omgflix.com	Video
onejav.com	Torrent-Websites
online24fullmovies.com	Video
openbittorrent.com	Torrent-Websites
openload-streamango.com	Video
openloadmov.com	Video
openwebtorrent.com	Torrent-Websites
orionoid.com	Video
otaku-streamers.com	Video
otakustv.com	Video
otorrent2.com	Torrent-Websites
otorrent4.com	Torrent-Websites
otorrents.com	Torrent-Websites
oxtorrent.com	Torrent-Websites
oxygen-warez.com	Warez
p2pdl.com	Torrent-Websites
p2pguru.com	Torrent-Websites
pangzitv.com	Video
paulamues.com	Warez
pcgamestorrents.com	Torrent-Websites
pcwarezbox.com	Warez
pelisplusgt.com	Video
piratebay-mirrors.com	Torrent-Websites
piratebay-proxylist.com	Torrent-Websites
piratebaylive.com	Torrent-Websites
piratebayproxyz.com	Torrent-Websites
piratebayy.com	Torrent-Websites
pirateiro.com	Torrent-Websites
piratepiratebay.com	Torrent-Websites
pirateproxy-bay.com	Torrent-Websites
tracker.piratepublic.com	Torrent-Trackers
piratesbaycc.com	Torrent-Websites
pjointe.com	FileHosting
playvidto.com	FileHosting
playwarez.com	Warez
plugintorrent.com	Torrent-Websites
pluspremieres.com	Audio
popcornflix.com	Video
pornevo.com	Torrent-Websites
portalultautv.com	Video
potuk.com	Torrent-Trackers
pow7.com	Torrent-Trackers
prefiles.com	FileHosting
privtracker.com	Torrent-Websites
progressivetorrents.com	Torrent-Websites
protvcollection.com	Video
proxieswegotproxies.com	Torrent-Websites
proxylisthere.com	Torrent-Websites
psarips.com	Video, Torrent-Websites
psvitaiso.com	Warez
psychodownloads.com	Warez
tracker.publicbt.com	Torrent-Trackers
put-locker.com	Video
putlocker.com	Video
putlockerfilms.com	Video
putlockers2.com	Video
putlockersflix.com	Video
putlockersfm.com	Video
qwemovies.com	Torrent-Websites
raidforums.com	Warez
rapidgatormovies.com	Video
rapidheaven.com	Warez
rarbg.com	Torrent-Websites
rarbgmirror.com	Torrent-Websites
rarbgs.com	Torrent-Websites
rarbgunblock.com	Torrent-Websites
rarbgunlocked.com	Torrent-Websites
rarbt.com	Torrent-Websites
rarefilmm.com	Video
rarelust.com	Video
real-debrid.com	FileHosting
redbeltmovie.com	Video
dpiui.reedlan.com	Torrent-Trackers
renrencili.com	Torrent-Websites
torrent.resonatingmedia.com	Torrent-Trackers
rgmechanics-games.com	Torrent-Websites
root-warez.com	Warez
russianfilmhub.com	Video
rustorka.com	Torrent-Websites
ryuanime.com	Video
savebt.com	Torrent-Websites
tracker.sbsub.com	Torrent-Trackers
scenep2p.com	Video
scribd.com	FileHosting
seekasong.com	Audio
sendspace.com	FileHosting
serieslan.com	Video
shanaproject.com	Torrent-Websites
sharetv.com	Video
siambt.com	Torrent-Trackers
simkl.com	Video
simplestorrent.com	Torrent-Websites
simpsonitos.com	Video
sirflix.com	Video
snagfilms.com	Video
snowfl.com	Torrent-Websites
soap2day.com	Video, Torrent-Websites
soap2dayfree.com	Video
soap2dayhd.com	Video
softswarez.com	Warez
softwarezon.com	Warez
sonofshun.com	Torrent-Websites
southparkstudios.com	Video
spanishtracker.com	Torrent-Websites
sportstreamshd.com	Video
starnetmovie.com	Video
stream-planet.com	Video
streamboox.com	Video
streamdor.com	Video
streamlord.com	Video, Torrent-Websites
streamwatchfree.com	Video
streamwoop.com	Video
stremio.com	Torrent-Clients, Torrent-Websites
stremiomovies.com	Video
subtituladas.com	Video
tc-boxing.com	Torrent-Trackers
telegucz.com	Warez
tenvoi.com	FileHosting
tfreeca22.com	Torrent-Websites
the-zomb.com	Torrent-Websites
theaudiobookbay.com	Torrent-Websites
thebigheap.com	Video
theebooksbay.com	Torrent-Websites
thehiddenbay.com	Torrent-Websites
thekickasstorrents.com	Torrent-Websites
thepirate-bayproxy.com	Torrent-Websites
thepiratebay1.com	Torrent-Websites
thepiratebaya.com	Torrent-Websites
thepiratebays.com	Torrent-Websites
thepirategoogle.com	Torrent-Websites
thepirateproxy3se.com	Torrent-Websites
thepiratesbay.com	Torrent-Websites
thewebflicks.com	Video
tikmovies.com	Video
tracker.tiny-vps.com	Torrent-Trackers
tioanime.com	Video
tixati.com	Torrent-Clients
to123movies.com	Video
todaum.com	Torrent-Websites
toorgle.com	Torrent-Websites
topdocumentaryfilms.com	Video
toppmovies.com	Video
torhd.com	Video, Torrent-Websites
torlock.com	Torrent-Websites
torlock2.com	Torrent-Websites
torrent-finder.com	Torrent-Websites
torrent-pirat.com	Torrent-Websites
torrent-tracks.com	Torrent-Websites
torrentbox.com	Torrent-Websites
torrentday.com	Torrent-Websites
torrentdia.com	Torrent-Websites
torrentdia2.com	Torrent-Websites
torrentdream.com	Torrent-Websites
torrentfunk.com	Torrent-Websites
torrentfunk2.com	Torrent-Websites
torrentgaga.com	Torrent-Websites
torrentgirls.com	Torrent-Websites
torrenthaja.com	Torrent-Websites
torrenthajo.com	Torrent-Websites
torrenthashes.com	Torrent-Websites
torrentkittyurl.com	Torrent-Websites
torrentleex.com	Torrent-Websites
torrentlike.com	Torrent-Websites
torrentmax15.com	Torrent-Websites
torrentmoa.com	Torrent-Websites
torrentmoatv.com	Torrent-Websites
torrentonly.com	Torrent-Websites
torrentoyunindir.com	Torrent-Websites
torrentpond.com	Torrent-Websites
torrentprivacy.com	Torrent-Websites
torrentproject.com	Torrent-Websites
torrentprotection.com	Torrent-Websites
torrentqq25.com	Torrent-Websites
torrentqq27.com	Torrent-Websites
torrentqq28.com	Torrent-Websites
torrentqq29.com	Torrent-Websites
torrentqq49.com	Torrent-Websites
torrentqq50.com	Torrent-Websites
torrentqq51.com	Torrent-Websites
torrentqq52.com	Torrent-Websites
torrentqq53.com	Torrent-Websites
torrentqq71.com	Torrent-Websites
torrentqq72.com	Torrent-Websites
torrentqq74.com	Torrent-Websites
torrents-proxy.com	Torrent-Websites
torrentsafe.com	Torrent-Clients
torrentsee23.com	Torrent-Websites
torrentsee24.com	Torrent-Websites
torrentseeker.com	Torrent-Websites
torrentsir18.com	Torrent-Websites
torrentsmd.com	Torrent-Trackers, Torrent-Websites
torrentsmirror.com	Torrent-Websites
torrentsnack.com	Torrent-Websites
tracker.torrentsnows.com	Torrent-Trackers
torrentspy.com	Torrent-Websites
torrentvery.com	Torrent-Websites
torrentway.com	Torrent-Websites
torrentwiz.com	Torrent-Websites
torrentwork.com	Torrent-Websites
torrentz.com	Torrent-Websites
torrentzeta.com	Torrent-Websites
torrentzoa.com	Torrent-Websites
torrentzozo.com	Torrent-Websites
tpb4proxy.com	Torrent-Websites
tpbaysproxy.com	Torrent-Websites
tpbpiratebayproxy.com	Torrent-Websites
tpbproxypirate.com	Torrent-Websites
tracker.trackerfix.com	Torrent-Trackers
trainsaw.com	Video
trancetraffic.com	Torrent-Websites
transmissionbt.com	Torrent-Clients
tribalmixes.com	Torrent-Trackers
tricitytorrents.com	Torrent-Websites
tt-torrent.com	Torrent-Websites
ttxunlei.com	Torrent-Websites
tubidymp3download.com	Audio
tudoubt.com	Torrent-Websites
turkish123.com	Video
th11.tv-movieonline.com	Video
tvbfsy.com	Torrent-Websites
tvchaosuk.com	Torrent-Websites
tracker.tvnihon.com	Torrent-Websites
twitth.com	Torrent-Websites
udush.com	Torrent-Websites
tracker0.ufibox.com	Torrent-Trackers
uhibo.com	Video
ukpiratebayproxy.com	Torrent-Websites
ummagurau.com	Video
unblockninja.com	Proxies
unblockrarbg.com	Torrent-Websites
unblocktorrent.com	Torrent-Websites
uncensoredjavtorrents.com	Torrent-Websites
universalmediaserver.com	Video
unlockedpiratebay.com	Torrent-Websites
uploadev.com	FileHosting
uploadgig.com	FileHosting
uploadrar.com	FileHosting
uppit.com	FileHosting
uptobox.com	FileHosting
mp3juices-app.en.uptodown.com	Audio
popcorn-time.en.uptodown.com	Torrent-Clients
uptostream.com	Video
usenet-crawler.com	UseNet
usenetic.com	UseNet
userscloud.com	FileHosting
utorrent.com	Torrent-Clients, Torrent-Websites
uutor.com	Torrent-Websites
vboku.com	Video
veoble.com	Torrent-Websites
verpeliculasultra.com	Video
viatorrents.com	Torrent-Websites
vidcloud9.com	Video
videoneat.com	Torrent-Websites
vidtodo.com	FileHosting
viduplayer.com	Video
vk.com	FileHosting
volokit.com	Video
vuze.com	Torrent-Clients, Torrent-Websites
warez-host.com	Warez
warez-serbia.com	Warez
warez10.com	Warez
warezchristian.com	Warez
warezcidayi.com	Warez
warezforums.com	Warez
warezheaven.com	Warez
warezhero.com	Warez
warezkeeper.com	Warez
warezlander.com	Warez
warezm.com	Warez
warezreleases.com	Warez
warezstore.com	Warez
wareztheme.com	Warez
wareztorrent.com	Torrent-Trackers
warezworm.com	Warez
wat32.com	Video
watch2021.com	Video
watch4freemovies.com	Video
watchcartoononline.com	Torrent-Websites
watchepisodes4.com	Video
watchordown.com	Video
watchraw.com	Video
watchsomuch.com	Torrent-Websites
wayupload.com	FileHosting
wcoforever.com	Video
wcostream.com	Video
wdupload.com	FileHosting
wonderfulsubs.com	Video
downloadmovietorrent.wordpress.com	Torrent-Websites
ps2torrentsgames.wordpress.com	Torrent-Websites
streamiza.wordpress.com	Video
wordpresswarezthemes.com	Warez
world-files.com	FileHosting
worldboxingvideoarchive.com	Torrent-Trackers
worldbytez.com	FileHosting
wushare.com	FileHosting
wwatchseries.com	Video
ns-1.x-fins.com	Torrent-Trackers
t.xatab-repack.com	Torrent-Websites
x5.xatab-repack.com	Torrent-Websites
xbox360iso.com	Warez
share.xfsub.com	Torrent-Websites
xie22.com	Torrent-Websites
xtorrentp2p.com	Torrent-Websites
xubster.com	FileHosting
xxx-tracker.com	Torrent-Websites
xxxtor.com	Torrent-Trackers
tracker.ygsub.com	Torrent-Trackers
yify-torrents.com	Torrent-Websites
yifyhdtorrent.com	Torrent-Websites
tracker.yoshi210.com	Torrent-Trackers
youpornbook.com	Torrent-Websites
yourbittorrent.com	Torrent-Websites
yourptflixmovies.com	Video
ytmp3juice.com	Audio
ytsmovietorrent.com	Torrent-Websites
ytsstreaming.com	Video
ytstorrent.com	Torrent-Websites
ytstorrentyts.com	Torrent-Websites
yui-nya.com	Torrent-Websites
yuptorrents.com	Torrent-Websites
zajefajna.com	Warez
zbigz.com	Torrent-Clients
tracker.zemoj.com	Torrent-Trackers
zhongzicili.com	Torrent-Websites
zhongzishenqi.com	Torrent-Websites
zippyshare.com	FileHosting
zoechip.com	Video
zone-warez.com	Warez
zooqle.com	Torrent-Websites
zxcmovies.com	Video
vibe.community	Torrent-Trackers
gostream.cool	Video
tpb.cool	Torrent-Websites
kickasstorrent.cr	Torrent-Websites
kickasstorrents.cr	Torrent-Websites
putlockers.cr	Video
rmz.cr	Video, Warez
scr.cr	Torrent-Websites
thepiratebay.cr	Torrent-Websites
cnp.cx	Torrent-Websites
cpabien.cx	Torrent-Websites
hdfilme.cx	Video
piratebayproxy.cx	Torrent-Websites
thepiratebay.cx	Torrent-Websites
123moviesc.cyou	Video
123movieshub.cyou	Video
cinevood.cyou	Video
fmovie.cyou	Video
thepb.cyou	Torrent-Websites
hd-cztorrent.cz	Torrent-Websites
polishsource.cz	Torrent-Websites
putlockers.cz	Video
123movie.date	Video
fmovies.date	Video
alldebrid.de	FileHosting
tracker.birkenwald.de	Torrent-Trackers
chihaya.de	Torrent-Trackers
fe.dealclub.de	Torrent-Trackers
vpn.flying-datacenter.de	Torrent-Trackers
kanal-4.de	Torrent-Trackers
mail.realliferpg.de	Torrent-Trackers
s2dfree.de	Video
tsecurity.de	Warez
xteve.de	Video
ftuapps.dev	Torrent-Websites
movie.squeezebox.dev	Video
lookmovie.digital	Video
putlocker.digital	Video
yts.digital	Torrent-Websites
mp3juice.dj	Audio
unblocked.dk	Proxies
123movies.domains	Video
audio.download	Audio
lookmovie.download	Video
diva.sfsu.edu	Video
01234movies.email	Video
movies123.email	Video
putlockers.email	Video
alldebrid.es	FileHosting
putlockers.es	Video
animeultima.eu	Video
bigbbs.eu	Torrent-Websites
btdb.eu	Torrent-Websites
central-torrent.eu	Torrent-Websites
dvdseed.eu	Torrent-Websites
freecztorrent.eu	Torrent-Websites
hdonline.eu	Video, Torrent-Websites
47.ip-51-68-199.eu	Torrent-Trackers
ns349743.ip-91-121-106.eu	Torrent-Trackers
jpopsuki.eu	Torrent-Websites
knapsu.eu	Video
livesx.eu	Torrent-Websites
open.lolicon.eu	Torrent-Trackers
mybayprox.eu	Torrent-Websites
myfeed2all.eu	Video
myp2px.eu	Video
nyaa.eu	Torrent-Websites
olevod.eu	Video
sktorrent.eu	Torrent-Websites
slosoul.eu	Torrent-Websites
super-warez.eu	Warez
tehconnection.eu	Torrent-Trackers
the-eye.eu	Video, Torrent-Websites, Warez
the123movies.eu	Video
torrent-games.eu	Torrent-Websites
torrentz.eu	Torrent-Websites
torrentz2.eu	Torrent-Websites
tpbpiratenbucht.eu	Torrent-Websites
tracker.vectahosting.eu	Torrent-Trackers
warezik.eu	Warez
x1337x.eu	Torrent-Websites
123movies.exposed	Video
thepiratebay.fail	Torrent-Websites
123movies.fan	Video
tracker.lelux.fi	Torrent-Trackers
tracker6.lelux.fi	Torrent-Trackers
pirateproxy.fi	Torrent-Websites
proxyproxy.fi	Torrent-Websites
cmovies.fm	Video
tracker.files.fm	Torrent-Trackers
putlockers.fm	Video
solarmovie.fm	Video, Torrent-Websites
lookmovie.foundation	Video
alldebrid.fr	FileHosting
benouworldtrip.fr	Torrent-Trackers
sd-161673.dedibox.fr	Torrent-Trackers
dl.free.fr	FileHosting
megadl.fr	FileHosting
torrent.soulofdreams.fr	Torrent-Websites
torrent9cz.fr	Torrent-Websites
123movies.fun	Video
123movies4u.fun	Video
123unblock.fun	Proxies
1337x.fun	Torrent-Websites
anime-tv.fun	Video
dbgo.fun	Video
duboku.fun	Video
ffmovie.fun	Video
isohunt.fun	Torrent-Websites
lookmovie.fun	Video
losmovies.fun	Video
m4ufree.fun	Video
solarmovie.fun	Video
unbl0ck.fun	Proxies
yesmovies.fun	Video
fux0r.fyi	Proxies
lookmovie.fyi	Video
putlocker.fyi	Video
123movies.ga	Video
123moviess.ga	Video
animesa.ga	Video
pirateproxy.ga	Torrent-Websites
playwire.ga	Video
putlockersmovie.ga	Video
ssanime.ga	Torrent-Websites
tracker.trackton.ga	Torrent-Trackers
123movies.gallery	Video
4torrent.games	Torrent-Websites
torrent4.games	Torrent-Websites
torrentred.games	Torrent-Websites
1337x.gd	Torrent-Websites
fmovies.gd	Video
thepiratebay.gd	Torrent-Websites
123moviess.gdn	Video
proxybay.gdn	Torrent-Websites
bt.acg.gg	Torrent-Websites
torrent9.gg	Torrent-Websites
torrentmax.gg	Torrent-Websites
apibay.gq	Torrent-Websites
tracker.btsync.gq	Torrent-Trackers
1337x.iamproxy.gq	Torrent-Websites
rarbg.iamproxy.gq	Torrent-Websites
qg.lorzl.gq	Torrent-Trackers
123movies.gr	Video
black-tracker.gr	Torrent-Websites
tracker.pirateparty.gr	Torrent-Trackers
filmesviatorrents.gratis	Torrent-Websites
pelisplus.gratis	Video
123movies.guide	Video
gomovies.guru	Video
thepiratebay.guru	Torrent-Websites
123movies.gy	Video
123movies.haus	Video
123movies.hospital	Video
putlocker.host	Video
thepirate.host	Torrent-Websites
putlocker.how	Video
movierulz.ht	Torrent-Websites
1337xhd.icu	Torrent-Websites
tracker.imgoingto.icu	Torrent-Trackers
moviestube.icu	Video
mp3-juice.icu	Audio
nocensor.icu	Proxies
novaopcj.icu	Torrent-Trackers
pelisplus.icu	Video
piratebay.icu	Torrent-Websites
prox4you.icu	Proxies
tr.ready4.icu	Torrent-Trackers
thepiratebay.icu	Torrent-Websites
unblockproject.icu	Proxies
uwatchfree.icu	Video
vidclouds.icu	Video
warez-bb.icu	Warez
movieee.my.id	Video
pirateproxy.id	Torrent-Websites
unblocked.id	Proxies
unblockit.id	Proxies
t1.leech.ie	Torrent-Trackers
t2.leech.ie	Torrent-Trackers
t3.leech.ie	Torrent-Trackers
bt.orzx.im	Torrent-Websites
animestream.in	Video
beemp3.in	Audio
elitetorrent.in	Torrent-Websites
filerio.in	FileHosting
gogoanime.in	Video, Torrent-Websites
mlmsoftwarez.in	Warez
moe4sale.in	Torrent-Websites
pahe.in	Torrent-Websites
piratebays.in	Torrent-Websites
simplestream.in	Video
time2watch.in	Video
tpblife.in	Torrent-Websites
utorrentz2.in	Torrent-Websites
videospider.in	Video
watchwrestling.in	Video
1337.abcvg.info	Torrent-Trackers
afdah.info	Video
anidex.info	Torrent-Websites
baypiratetpb.info	Torrent-Websites
binsearch.info	UseNet
bitnova.info	Torrent-Websites
bitsparadise.info	Torrent-Trackers
cyberwarez.info	Warez
bt.edwardk.info	Torrent-Trackers, Torrent-Websites
bt2.edwardk.info	Torrent-Trackers
erai-raws.info	Torrent-Websites
gameloo.info	Warez
tracker.gbitt.info	Torrent-Trackers
tracker-udp.gbitt.info	Torrent-Trackers
grifon.info	Torrent-Trackers
hdreactor.info	Torrent-Websites
hikarinoakariost.info	Audio
horriblesubs.info	Torrent-Websites
icefilms.info	Torrent-Websites
iitv.info	Video
ilcorsaronero.info	Torrent-Websites
limetorrents.info	Torrent-Websites
mp3skulls.info	Audio
mults.info	Torrent-Websites
nyaatorrents.info	Torrent-Websites
pirate-bay.info	Torrent-Websites
piratebay1.info	Torrent-Websites
piratebayproxy.info	Torrent-Websites
prox4.info	Proxies
putlockertv.info	Video
rapidvideo.info	Video
repack.info	Torrent-Websites
rustorrents.info	Torrent-Websites
rutor.info	Torrent-Websites
swatchseries.info	Video
thekat.info	Torrent-Websites
thepiratebay9.info	Torrent-Websites
thepiratebays.info	Torrent-Websites
thzhd.info	Torrent-Websites
tokyotosho.info	Torrent-Websites
topstreams.info	Video
torlook.info	Torrent-Websites
torrage.info	Torrent-Websites
torrent-finder.info	Torrent-Websites
torrentdownload.info	Torrent-Websites
tosarang.info	Torrent-Websites
admin.videoenpoche.info	Torrent-Trackers
watchkobe.info	Video
yeyemo.info	Torrent-Websites
ytsmovies.info	Torrent-Websites
solarmovie.ink	Video
0gomovies.io	Video
123putlocker.io	Video
animeflix.io	Video
animeseries.io	Video
animesuge.io	Video
bitport.io	Torrent-Clients, Torrent-Websites
blokas.io	Torrent-Trackers
btdb.io	Torrent-Websites
crackstreams.io	Video
cuevana2.io	Video
emovies.io	Video
europixhd.io	Video
eztv.io	Torrent-Websites
filelist.io	Torrent-Websites
tracker.fortu.io	Torrent-Trackers
gamestorrents.io	Torrent-Websites
proxybay.github.io	Torrent-Websites
rakshasa.github.io	Torrent-Clients
tornado-torrent.gitlab.io	Torrent-Clients
gktorrent.io	Torrent-Websites
gogoanime.io	Video
hindilinks4u.io	Video
instant.io	Torrent-Clients
itorrent.io	Torrent-Websites
letsupload.io	FileHosting
lookmovie.io	Video
mac-torrents.io	Torrent-Websites
magnetoo.io	Video, Torrent-Clients, Torrent-Websites
mp3juice.io	Audio
ohh.io	Video
putlockerhd.io	Video
series9.io	Torrent-Websites
spacemov.io	Torrent-Websites
torrentproxy.io	Torrent-Websites
torrents.io	Torrent-Websites
torrentz.io	Torrent-Websites
vidstreaming.io	Video
vivatv.io	Video
watchcartoononline.io	Torrent-Websites
watchtvseries.io	Video
webtor.io	Torrent-Clients
webtorrent.io	Torrent-Clients, Torrent-Websites
xmovies8.io	Video
yts.io	Torrent-Websites
bitdl.ir	Warez
clubfilm.ir	Video
torrent.ir	Torrent-Websites
tracker.0o.is	Torrent-Trackers
1337x.is	Torrent-Websites
1movies.is	Video, Torrent-Websites
cinecalidad.is	Torrent-Websites
tracker.cyberia.is	Torrent-Trackers
demonoid.is	Torrent-Websites
tracker.ds.is	Torrent-Trackers
getpopcorntime.is	Torrent-Clients
gomoviesfree.is	Video
hydrax.is	Video
iwannawatch.is	Video, Torrent-Websites
moviewatcher.is	Video
mp3juices.is	Audio
myflixer.is	Video
nites.is	Video
nostalgic.is	Torrent-Websites
noxx.is	Video
nulled.is	Warez
onionplay.is	Video
popcorntime.is	Video
putlockerr.is	Video
putlockers.is	Video
rainierland.is	Video
rarbg.is	Torrent-Websites
ripple.is	Video
rutor.is	Torrent-Websites
s2dfree.is	Video
shiro.is	Video
soap2day.is	Video
stream2watch.is	Video
torrent9.is	Torrent-Websites
torrentz2.is	Torrent-Websites
unblocked.is	Proxies, Torrent-Websites
watch32.is	Video
xmovies8.is	Video
yggtorrent.is	Torrent-Websites
putlockertv.ist	Video
alldebrid.it	FileHosting
eztv.it	Torrent-Websites
myflixer.it	Video
snahp.it	Video, Warez
yomovies.it	Video
megatorrents.kg	Torrent-Trackers
gomovies.kim	Video
torrenti.co.kr	Torrent-Websites
unblocked.krd	Proxies
gomovies.kz	Video
putlocker.kz	Video
123movies.la	Video
animeflv.la	Video
audiobookbay.la	Torrent-Websites
btspread.la	Torrent-Websites
lookmovie.la	Video
mp4ba.la	Torrent-Websites
putlockers.la	Video
solarmovies.la	Video
torrentkitty.la	Torrent-Websites
watchcartoonsonline.la	Video
watchwrestling.la	Video
pirateproxy.lat	Torrent-Websites
yts.lat	Torrent-Websites
thepiratebay.lc	Torrent-Websites
unblocked.lc	Proxies
vipbox.lc	Video
vipleague.lc	Video
yts.lc	Torrent-Websites
kat.li	Torrent-Websites
primewire.li	Video
chihaya.toss.li	Torrent-Trackers
utorrent.li	Torrent-Websites
yggtorrent.li	Torrent-Websites
123movies4u.life	Video
bypassed.life	Proxies
flixtor.life	Video
piratebay.life	Torrent-Websites
yts.life	Torrent-Websites
123movies.link	Video
1337x.link	Torrent-Websites
247prox.link	Torrent-Websites
baypiraat.link	Torrent-Websites
limetorrents.link	Torrent-Websites
myflixer.link	Video
proxahoy.link	Torrent-Websites
proxyproxyproxyproxy.link	Torrent-Websites
rarbg.link	Torrent-Websites
tpbgreen.link	Torrent-Websites
0123movies.live	Video
5movies.live	Video
allwrestling.live	Video
baked.live	Video
clckr.live	Video
ironanime.live	Video
losmovies.live	Video
movie4u.live	Video
pelisplus.live	Video
piratebay.live	Torrent-Websites
piratebay1.live	Torrent-Websites
piratebayproxy.live	Torrent-Websites
pirateproxy.live	Torrent-Websites
rarbg.live	Torrent-Websites
sporthd.live	Video
streameast.live	Video
thepirate.live	Torrent-Websites
thepiratebay1.live	Torrent-Websites
vipbox.live	Torrent-Websites
zionapp.live	Video
nyafilmer.lol	Video
skytorrents.lol	Torrent-Websites
unblocked.lol	Proxies, Torrent-Websites
xmovies8.lol	Video
123moviesfree.love	Video
gustatv.love	Video
kisscartoon.love	Video
yesmovies.love	Video
yts.lt	Torrent-Websites
tk.mabo.ltd	Torrent-Trackers
ipv4.tracker.harry.lu	Torrent-Trackers
ipv6.tracker.harry.lu	Torrent-Trackers
hdfull.lv	Video
sinister.ly	Warez
123moviesfull.me	Video
123moviestv.me	Video
1watch-free.me	Video
6box.me	UseNet
720pstream.me	Video, Torrent-Websites
aloanime.me	Video
anime8.me	Torrent-Websites
animeow.me	Video
aniwatch.me	Video
audiobookbay.me	Torrent-Websites
awesome-hd.me	Torrent-Websites
axxo.me	Video
bakabt.me	Torrent-Websites
best-series.me	Video
bibliotik.me	Torrent-Websites
chia-anime.me	Video
cilidaquan.me	Torrent-Websites
ddl.me	Video
ddlvalley.me	Video, Warez
demons-eye.me	Torrent-Websites
desirulez.me	Warez
duboku.me	Video
filestream.me	Torrent-Clients
gounlimited.me	Video
highlightstore.me	Video
javtorrent.me	Torrent-Websites
kinotorrent.me	Torrent-Websites
kissseries.me	Video
tracker.kuroy.me	Torrent-Trackers
learnbits.me	Torrent-Trackers
magnet4you.me	Torrent-Websites
mgnet.me	Torrent-Websites
mkvking.me	Video
tracker.moeking.me	Torrent-Trackers
movie360.me	Video
nelion.me	FileHosting
tracker.nitrix.me	Torrent-Trackers
nnm-club.me	Torrent-Websites
omgtorrent.me	Torrent-Websites
openloadfreetv.me	Video
passthepopcorn.me	Torrent-Websites
pelisplus.me	Video
predb.me	Torrent-Websites
putlocker.me	Video
putlocker123.me	Video
rarbg.me	Torrent-Websites
scnlog.me	Video
scnsrc.me	Warez
seedboxs.me	Torrent-Websites
seedpeer.me	Torrent-Websites
tracker.shkinev.me	Torrent-Trackers
speedsports.me	Torrent-Websites
thepiratefilmestorrent.me	Torrent-Websites
torrent4you.me	Torrent-Websites
torrentdownloads.me	Torrent-Websites
torrentkitty.me	Torrent-Websites
torrents.me	Torrent-Websites
torrentz2eu.me	Torrent-Websites
torrentz2is.me	Torrent-Websites
tsearch.me	Torrent-Websites
typhoontv.me	Video
denis.stalker.upeer.me	Torrent-Trackers
vidlox.me	FileHosting
vidsrc.me	Video
viprow.me	Video
vmovee.me	Torrent-Websites
watchtvepisodes.me	Video
worldcupfootball.me	Video
yugenani.me	Video
cybercloud.media	Video
lookmovie.media	Video
gomovies.men	Video
putlocker.menu	Video
streamy-flix.my-trials.ml	Video
proxypirate.ml	Torrent-Websites
torrent-paradise.ml	Torrent-Websites
torrents-csv.ml	Torrent-Websites
vidsrc.ml	Video
4movierulz.mn	Video
putlockers.mn	Video
uwatchfree.mn	Video
beemp3.mobi	Audio
cuevana3.mobi	Video
lookmovie.mobi	Video
anidex.moe	Torrent-Trackers, Torrent-Websites
animedaisuki.moe	Video
animeyt.moe	Video
bangumi.moe	Torrent-Websites
because.moe	Video
catbox.moe	Torrent-Websites
git.fuwafuwa.moe	Torrent-Websites
haho.moe	Video
mahou-shoujo.moe	Torrent-Websites
tenshi.moe	Video
twist.moe	Video, Torrent-Websites
123movies.mom	Video
123unblock.monster	Proxies
thepiratebay.monster	Torrent-Websites
tpb.monster	Torrent-Websites
putlockers.movie	Video
torrent.movie	Torrent-Websites
watchseries.movie	Video
yesmovies.movie	Video
2ddl.ms	Video
babytorrent.ms	Torrent-Websites
yts.ms	Torrent-Websites
yts.mt	Torrent-Websites
123movies.mx	Video
zenkimex.com.mx	Video
soap2day.mx	Video
uwatchfree.mx	Video
yts.mx	Torrent-Websites
pirateproxy.name	Torrent-Websites
0dayhome.net	Warez
123fox.net	Video
123movies.net	Video
123moviesfree.net	Video
123moviestv.net	Video
2streaming.net	Video
2torrentz.net	Torrent-Websites
321n.net	Torrent-Websites
4watch.net	Video
5moviesfree.net	Video
61626c.net	Torrent-Trackers
6movies.net	Video
torrenttracker.nwc.acsalaska.net	Torrent-Trackers
alfafile.net	FileHosting
bt.ali213.net	Torrent-Trackers, Torrent-Websites
tracker.ali213.net	Torrent-Trackers
all4nothin.net	Torrent-Trackers
altbinz.net	UseNet
ani-tsuzuki.net	Torrent-Websites
animeflv.net	Video
animekl.net	Video
animereborn.net	Video
aninow.net	Video
anzfile.net	FileHosting
multiki.arjlover.net	Torrent-Websites
torrent.arjlover.net	Torrent-Trackers
retracker.baikal-telecom.net	Torrent-Trackers
baixarfilmetorrent.net	Torrent-Websites
tracker.baltracker.net	Torrent-Trackers
beetvapk.net	Video
bemovies.net	Video
big-boss-tracker.net	Torrent-Trackers, Torrent-Websites
bilasport.net	Video
bitspyder.net	Torrent-Websites
blackcats-games.net	Torrent-Trackers
tracker.blacksparrowmedia.net	Torrent-Trackers
blacktiesports.net	Video
broadcasthe.net	Torrent-Websites
brotorrent.net	Torrent-Websites
brupload.net	FileHosting
bthuahua.net	Torrent-Websites
btshoufa.net	Torrent-Websites
bytewarez.net	Warez
cartooncrazy.net	Video
castradio.net	Torrent-Websites
cataz.net	Video
cineb.net	Video
cjoint.net	FileHosting
cmovieshd.net	Video
comandotorrenthd.net	Torrent-Websites
comandotorrentshd.net	Torrent-Websites
coolwareznik.net	Warez
coronamovies.net	Video
tracker.cyber-hub.net	Torrent-Trackers
cztorrent.net	Torrent-Websites
data-bg.net	Torrent-Trackers
datascene.net	Torrent-Trackers
derpyradio.net	Torrent-Trackers
deviloid.net	Torrent-Trackers
divpelis.net	Video
divxtotal3.net	Torrent-Websites
documental-torrents.net	Torrent-Websites
docuwiki.net	Torrent-Websites
dokumentalne.net	Video
dopebox.net	Video
downturk.net	Warez
dpstream.net	Video
dubbedanime.net	Video
duboku.net	Video
duckwad.net	Torrent-Websites
tracker.e-utp.net	Torrent-Trackers
eagletorrents.net	Torrent-Websites
edmag.net	Torrent-Websites
elitetorrent.net	Torrent-Websites
ev01.net	Video
fastani.net	Video
filedown.net	FileHosting
filmitorrent.net	Torrent-Websites
filmlicious.net	Video
flenix.net	Video
flixgo.net	Torrent-Websites
flixhq.net	Video
flixpad.net	Video
flux-gamer.net	Torrent-Websites
fmoviefree.net	Video
fmoviesgo.net	Video
forowarez.net	Warez
free-mp3-download.net	Audio
freshmoviestreams.net	Video
tracker.frozen-layer.net	Torrent-Trackers
furk.net	FileHosting
fzmovies.net	Video
gamemp3s.net	Torrent-Websites
gay-torrents.net	Torrent-Websites
gazellegames.net	Torrent-Websites
tracker.hama3.net	Torrent-Trackers
hdbest.net	Video
hdfilmer.net	Video
hitfile.net	FileHosting
hitzwarez.net	Warez
bbs.homefei.net	Torrent-Websites
hon3yhd.net	Torrent-Websites
hugefiles.net	FileHosting
tracker.internetwarriors.net	Torrent-Trackers
isohunt2.net	Torrent-Websites
javccdd.net	Torrent-Websites
jetload.net	FileHosting
jkanime.net	Video
juegostorrentpc.net	Torrent-Websites
jujufilm.net	Video
katushka.net	Torrent-Websites
kinokong.net	Torrent-Websites
lifanmoe.net	Torrent-Websites
loushao.net	Torrent-Trackers
mac-torrent-download.net	Torrent-Websites
macwarez.net	Warez
mediaboxhd.net	Video
megatorrentshd.net	Torrent-Websites
mejortorrent1.net	Torrent-Websites
mejortorrents1.net	Torrent-Websites
mejortorrentt.net	Torrent-Websites
mo9999.net	Torrent-Websites
mobivid.net	Video
mohmo.net	Torrent-Websites
monkeystream.net	Video
moviecave.net	Video
moviecracker.net	Video
moviego.net	Video
movienyt.net	Video
movies-free.net	Video
moviesjoy.net	Video
moviesleak.net	Torrent-Websites
movieunlimited.net	Video
mp3-juices.net	Audio
mp3fusion.net	Audio
torrent.mp3quran.net	Torrent-Trackers, Torrent-Websites
music-torrent.net	Torrent-Websites
musichq.net	Video
myanonamouse.net	Torrent-Websites
mypiratebay.net	Torrent-Websites
nhentai.net	Torrent-Websites
nitroflare.net	FileHosting
noobftp1.noobsubs.net	Torrent-Websites
tracker.noobsubs.net	Torrent-Trackers
novamovie.net	Video
novaset.net	Torrent-Websites
nyaa.net	Torrent-Websites
nzbget.net	UseNet
torrents.ohys.net	Torrent-Websites
onceddl.net	Video
onepace.net	Video
openloadmov.net	Video
openloadmovies.net	Torrent-Websites
openpiratbay.net	Torrent-Websites
orej.net	Video
otxataba.net	Torrent-Websites
ns389251.ovh.net	Torrent-Trackers
peliculaswarez.net	Warez
pelisplushd.net	Video
pianyuan.net	Torrent-Websites
piecejointe.net	FileHosting
piracyproxy.net	Proxies
pirate-bay.net	Torrent-Websites
pirate-bays.net	Torrent-Websites
piratebay-proxy.net	Torrent-Websites
piratebay-proxylist.net	Torrent-Websites
piratebayorg.net	Torrent-Websites
piratepirate.net	Torrent-Websites
piratepiratepirate.net	Torrent-Websites
pirateunblocker.net	Torrent-Websites
popsnap.net	Video
proxybayproxies.net	Torrent-Websites
prwatch.net	Video
publictorrent.net	Torrent-Websites
putlocker2021.net	Video
putlockerfree.net	Video
putlockers.net	Video
quitt.net	Video
racinghd.net	Video
rapidgator.net	FileHosting
rarbgtorrent.net	Torrent-Websites
redpiraat.net	Torrent-Websites
relizer.net	Torrent-Websites
repackov.net	Torrent-Websites
rlslog.net	Warez
rustorrents.net	Torrent-Websites
scene-rls.net	Video
thepiratebay.se.net	Torrent-Websites
seedoff.net	Torrent-Websites
seeingblind.net	Video
seriesfilmestorrent.net	Torrent-Websites
seriesonlinehd.net	Video
retracker.sevstar.net	Torrent-Trackers
sexinsex.net	Torrent-Websites
sharemovies.net	Video
shnflac.net	Torrent-Trackers
showbox-movies.net	Video
showboxmovies.net	Video
simfileshare.net	FileHosting
tracker.skyts.net	Torrent-Trackers
smilestv.net	Video
soccerstreams.net	Video
sockshare.net	Video
solarmovie.net	Video
solidtorrents.net	Torrent-Websites
sportsurge.net	Video
streamanimetv.net	Video
super-warez.net	Warez
supercartoons.net	Video
tapochek.net	Torrent-Websites
tracker.teambelgium.net	Torrent-Trackers
tehparadox.net	Warez
themoviebay.net	Video
thepiratebay9.net	Torrent-Websites
thepiratecity.net	Warez
thepirateproxybaylist.net	Torrent-Websites
thewareztr.net	Warez
tinyls.net	Video
tinyzonehd.net	Video
todaydown.net	Torrent-Websites
tomoa.net	Torrent-Websites
toonova.net	Video, Torrent-Websites
topeuropix.net	Torrent-Websites
topmoviesonline.net	Video
torrent-team.net	Torrent-Trackers
torrent-tracks.net	Torrent-Websites
torrent-windows.net	Torrent-Websites
torrentbd.net	Torrent-Websites
torrentbit.net	Torrent-Websites
tracker.torrentbytes.net	Torrent-Trackers
torrentdosfilmes2.net	Torrent-Websites
torrentdosfilmeshd2.net	Torrent-Websites
torrenter.net	Torrent-Websites
torrenters.net	Torrent-Websites
torrentfilmes.net	Torrent-Websites
torrentkitty.net	Torrent-Websites
torrentline.net	Torrent-Websites
torrentlinks.net	Torrent-Websites
torrentmac.net	Torrent-Websites
torrentmafya.net	Torrent-Websites
torrentmoon.net	Torrent-Websites
torrentreactor.net	Torrent-Websites
torrentube.net	Torrent-Websites
torrentview10.net	Torrent-Websites
torrentview9.net	Torrent-Websites
tosarang.net	Torrent-Websites
turbobit.net	FileHosting
uatracker.net	Torrent-Trackers
ukpiratebay.net	Torrent-Websites
unblockpiratebay.net	Torrent-Websites
unblockthe.net	Proxies
uniquestream.net	Video
unlockpiratebay.net	Torrent-Websites
uploaded.net	FileHosting
uraltrack.net	Torrent-Websites
usawarez.net	Warez
vidembed.net	Video
vidnext.net	Video
vidoza.net	FileHosting
vikv.net	Video
warezcrack.net	Warez
wareziens.net	Warez
warezok.net	Warez
watchfilm.net	Video
watchwrestling24.net	Video
weareproxylist.net	Torrent-Websites
wipfiles.net	FileHosting
worldofp2p.net	Torrent-Websites
xwt-classics.net	Torrent-Trackers
yuwabits.net	Torrent-Trackers
zamunda.net	Torrent-Websites
mail2.zelenaya.net	Torrent-Trackers
zone-torrent.net	Torrent-Trackers
dutafilm.network	Video
orpheus.network	Torrent-Websites
thepiratebay.news	Torrent-Websites
putlocker.ninja	Video
putlockers.ninja	Video
wearethereal.ninja	Torrent-Websites
1movies.nl	Torrent-Websites
tracker.altrosky.nl	Torrent-Trackers
audiobookbay.nl	Torrent-Websites
bayindia.nl	Torrent-Websites
bmovies.nl	Video
code2chicken.nl	Torrent-Trackers
tracker.dutchtracking.nl	Torrent-Trackers
eddie4.nl	Torrent-Trackers
elitetorrent.nl	Torrent-Websites
filmxy.nl	Video, Torrent-Websites
grantorrent.nl	Torrent-Websites
katmoviehd.nl	Video
prestige.minimafia.nl	Torrent-Trackers
tracker.open-internet.nl	Torrent-Trackers
s2dfree.nl	Video
seehd.nl	Video
cuevana.nu	Video
gamestorrents.nu	Torrent-Websites
gnula.nu	Video
pte.nu	Torrent-Websites
mega.co.nz	FileHosting
isohunt.nz	Torrent-Websites
kissanime.nz	Video
kisscartoon.nz	Video
mega.nz	FileHosting
torrent.nz	Torrent-Websites
0123movies.one	Video
boatred.one	Torrent-Websites
europix.one	Video
go123movies.one	Video
moviesjoy.one	Video
piratbaytpb.one	Torrent-Websites
piratebay.one	Torrent-Websites
piratesbay.one	Torrent-Websites
pubfilm.one	Video
solarmovie.one	Video
torrentx.one	Torrent-Websites
tpb.one	Torrent-Websites
kickass.onl	Torrent-Websites
layarkaca21.onl	Video
moviesjoy.onl	Video
proxybay.onl	Torrent-Websites
putlocker.onl	Video
putlockertv.onl	Video
123movies.online	Video
attack-on-titan.online	Video
coolmoviezone.online	Video
tracker.corpscorp.online	Torrent-Trackers
cynemas.online	Video
easymovie.online	Video
ettv.online	Torrent-Websites
filmzenstream.online	Video
jkanime.online	Video
jkanime2.online	Video
limetorrents.online	Torrent-Websites
live-sport.online	Video
movieultima.online	Video
pelisplus.online	Video
piratebaylive.online	Torrent-Websites
putlockerss.online	Video
rarbg-torrent.online	Torrent-Websites
thepiratebaytorrent.online	Torrent-Websites
unbl0ck.online	Proxies
wassermann.online	Torrent-Trackers
xoomtv.online	Video
fux0r.ooo	Proxies
1-thepiratebay.org	Torrent-Websites
123moviesme.org	Video
123streams.org	Video
1337xmovies.org	Torrent-Websites
247pirate.org	Torrent-Websites
247proxydl.org	Torrent-Websites
2piratebay.org	Torrent-Websites
7tor.org	Torrent-Websites
alicili.org	Torrent-Websites
androidkino.org	Torrent-Websites
anime-loads.org	Video
animeholics.org	Video
animetoon.org	Video, Torrent-Websites
animetosho.org	Torrent-Websites
audionews.org	Torrent-Websites
baravik.org	Torrent-Websites
batflix.org	Video
beatrice-raws.org	Torrent-Websites
beemp3s.org	Audio
bigfangroup.org	Torrent-Websites
bigtracker.org	Torrent-Websites
bithq.org	Torrent-Trackers
bitmetv.org	Torrent-Websites
bitru.org	Torrent-Websites
bluebird-hd.org	Torrent-Trackers
boatairproxy.org	Torrent-Websites
labs.boramalper.org	Torrent-Websites
bt4g.org	Torrent-Websites
btdigg.org	Torrent-Websites
bteye.org	Torrent-Websites
btor.org	Torrent-Websites
btsay.org	Torrent-Websites
butterproject.org	Torrent-Clients
ccmixter.org	Audio
cinebloom.org	Video
comandotorrents.org	Torrent-Websites
comicat.org	Torrent-Websites
concen.org	Torrent-Trackers, Torrent-Websites
trace.corrupt-net.org	Torrent-Websites
cosmobox.org	FileHosting
crickfree.org	Video, Torrent-Websites
cyberphoenix.org	Warez
ddl-warez.org	Warez
deluge-torrent.org	Torrent-Clients, Torrent-Websites
digbt.org	Torrent-Websites
dirtywarez.org	Warez
dler.org	Torrent-Websites
share.dmhy.org	Torrent-Websites
dontorrent.org	Torrent-Websites
dontorrents.org	Torrent-Websites
downloadwarez.org	Warez
dx-team.org	Warez
tracker.dyne.org	Torrent-Trackers
dyxz.org	Torrent-Websites
g.e-hentai.org	Torrent-Websites
emtrek.org	Torrent-Websites
eogli.org	Torrent-Websites
tracker.etree.org	Torrent-Trackers
torrent.eu.org	Torrent-Trackers
1.tracker.eu.org	Torrent-Trackers
2.tracker.eu.org	Torrent-Trackers
3.tracker.eu.org	Torrent-Trackers
ex-torrenty.org	Torrent-Websites
exitorrent.org	Torrent-Websites
explodie.org	Torrent-Trackers
ffbox.org	Video
filedown.org	FileHosting
files4you.org	Warez
finbytes.org	Torrent-Trackers
bt.firebit.org	Torrent-Trackers
flashtorrents.org	Torrent-Websites
flixy.org	Video
fmoviesc.org	Video
freebfg.org	Torrent-Websites
fullmoviefilm.org	Video
fullversions.org	Warez
funfile.org	Torrent-Trackers
cdn-1.gamecoast.org	Torrent-Trackers
cdn-2.gamecoast.org	Torrent-Trackers
games4theworld.org	Torrent-Websites
gmt-max.org	Torrent-Websites
gomovies-hd.org	Video
greasyfork.org	Warez
gtorrent.org	Torrent-Websites
hd-space.org	Torrent-Websites
hd-torrents.org	Torrent-Websites
hdmonkey.org	Torrent-Websites
hdpopcorns.org	Video
hdreactor.org	Torrent-Trackers, Torrent-Websites
hhdmovies.org	Video
hqsource.org	Torrent-Websites
hurawatch.org	Video
itorrents.org	Torrent-Websites
justdubs.org	Video
blog.jxzmz.org	Torrent-Websites
tracker.kali.org	Torrent-Trackers
sub.kamigami.org	Torrent-Websites
tracker.kamigami.org	Torrent-Trackers
kaoskrew.org	Torrent-Websites
kaztorka.org	Torrent-Websites
kcnawatch.org	Video
kickass2.org	Torrent-Websites
kinotracker.org	Torrent-Websites
kisssub.org	Torrent-Websites
tracker.leechers-paradise.org	Torrent-Trackers
leopard-raws.org	Torrent-Websites
lepiratebay.org	Torrent-Websites
letsupload.org	FileHosting
libertyvf.org	Video
libtorrent.org	Torrent-Websites
lunchflix.org	Video
magnetfox.org	Torrent-Websites
mamahd.org	Torrent-Websites
media-torrent.org	Torrent-Websites
megatorrentshd.org	Torrent-Websites
mejortorrentt.org	Torrent-Websites
mesfichiers.org	FileHosting
metalarea.org	Torrent-Websites
mgtracker.org	Torrent-Trackers
nipponsei.minglong.org	Torrent-Websites
tracker.minglong.org	Torrent-Trackers
mininova.org	Torrent-Websites
mitorrent.org	Torrent-Websites
monova.org	Torrent-Websites
movie4k.org	Video
movie4u.org	Video
moviefiles.org	Video, Torrent-Websites
movieheaven.org	Video
movieparadise.org	Video
moviestreamhd.org	Video
mp3-juice.org	Audio
mvgroup.org	Torrent-Trackers
myspleen.org	Torrent-Websites
tracker.nanoha.org	Torrent-Trackers
nulledwarez.org	Warez
oneddl.org	Warez
openpirate.org	Torrent-Websites
opentor.org	Torrent-Trackers
opentrackers.org	Torrent-Websites
tracker.opentrackr.org	Torrent-Trackers
tracker.parrotlinux.org	Torrent-Trackers
tracker.parrotsec.org	Torrent-Trackers
pc-torrent.org	Torrent-Websites
peerfect.org	Torrent-Trackers
pelisplus.org	Video
picotorrent.org	Torrent-Clients
pirate-bay-proxy.org	Torrent-Websites
piratebaaiahoy.org	Torrent-Websites
piratebay.org	Torrent-Websites
piratebay-proxy.org	Torrent-Websites
piratebays.org	Torrent-Websites
piratebaysproxies.org	Torrent-Websites
piratetorrent.org	Torrent-Websites
pitkini.org	Video
public.popcorn-tracker.org	Torrent-Trackers
share.popgo.org	Torrent-Websites
powertracker.org	Torrent-Websites
proaudiotorrents.org	Torrent-Trackers
prostylex.org	Torrent-Websites
proxbaypirate.org	Torrent-Websites
proxifiedpiratebay.org	Torrent-Websites
proxyrarbg.org	Torrent-Websites
puredl.org	Warez
bt.pusacg.org	Torrent-Trackers
tracker.pussytorrents.org	Torrent-Trackers
puzo.org	Warez
qbittorrent.org	Torrent-Clients, Torrent-Websites
rapload.org	Audio
rarbg2018.org	Torrent-Websites
rarbg2019.org	Torrent-Websites
rarbg2020.org	Torrent-Websites
rarbgaccess.org	Torrent-Websites
rarbgaccessed.org	Torrent-Websites
rarbgcore.org	Torrent-Websites
rarbgdata.org	Torrent-Websites
rarbgenter.org	Torrent-Websites
rarbgget.org	Torrent-Websites
rarbggo.org	Torrent-Websites
rarbgmirror.org	Torrent-Websites
rarbgmirrored.org	Torrent-Websites
rarbgp2p.org	Torrent-Websites
rarbgproxied.org	Torrent-Websites
rarbgproxy.org	Torrent-Websites
rarbgprx.org	Torrent-Websites
rarbgto.org	Torrent-Websites
rarbgtor.org	Torrent-Websites
rarbgtorrents.org	Torrent-Websites
rarbgunblocked.org	Torrent-Websites
rarbgway.org	Torrent-Websites
rarbgweb.org	Torrent-Websites
rg-mechanics.org	Torrent-Websites
rockhard-lossless.org	Torrent-Websites
rutracker.org	Torrent-Websites
sabnzbd.org	UseNet
tracker.tntvillage.scambioetico.org	Torrent-Trackers
seventorrents.org	Torrent-Websites
sganime.org	Video
soapgate.org	Video
softddl.org	Warez
sportsbay.org	Video
spzang.org	Torrent-Websites
streamdreams.org	Video
subsplease.org	Torrent-Websites
takemetal.org	Audio
tracker.tambovnet.org	Torrent-Trackers
tracker.tamersunion.org	Torrent-Trackers
tracker.tasvideos.org	Torrent-Trackers
the-piratebay.org	Torrent-Websites
thenftbay.org	Torrent-Websites
thepirate-bay.org	Torrent-Websites
thepiratebay.org	Torrent-Websites
thepiratebay-unblocked.org	Torrent-Websites
thepiratebay-us.org	Torrent-Websites
thepiratebay0.org	Torrent-Websites
thepiratebay10.org	Torrent-Websites
thepiratebay11.org	Torrent-Websites
thepiratebay3.org	Torrent-Websites
thepiratebayorg.org	Torrent-Websites
thepiratefilmes4k.org	Torrent-Websites
thepiratespace.org	Torrent-Websites
thetracker.org	Torrent-Trackers
thetradersden.org	Torrent-Trackers
topmoviesonline.org	Video
torrent-igruha.org	Torrent-Websites
torrentgalaxy.org	Torrent-Websites
torrentleech.org	Torrent-Websites
torrentproject2.org	Torrent-Websites
s1.torrents-igruha.org	Torrent-Websites
torrenty.org	Torrent-Websites
torrentz2eu.org	Torrent-Websites
torrentzeu.org	Torrent-Websites
torrentzilla.org	Torrent-Trackers
tparser.org	Torrent-Websites
traht.org	Torrent-Websites
two-movies.org	Video
uhdbits.org	Torrent-Websites
uhdmv.org	Video
unblockall.org	Proxies
unblocktheship.org	Torrent-Websites
uniondht.org	Torrent-Websites
unionpeer.org	Torrent-Websites
uploadev.org	FileHosting
utorrentgames.org	Torrent-Websites
tracker.v6speed.org	Torrent-Trackers
dl3.vaiomusic.org	Warez
vexmovies.org	Video, Torrent-Websites
vf-stream.org	Video
viatorrents.org	Torrent-Websites
vidlink.org	Video
vidoza.org	FileHosting
volno.org	Warez
vstorrent.org	Torrent-Websites
warez-bb.org	Warez
warez-ts.org	Warez
warez-world.org	Warez
warezhr.org	Warez
warezturkey.org	Warez
watch0123movies.org	Video
watchsomuch.org	Torrent-Websites
worldsrc.org	Torrent-Websites
xtorrenty.org	Torrent-Websites
shadowshq.yi.org	Torrent-Trackers
ytorrent.org	Torrent-Websites
yts-torrents.org	Torrent-Websites
zhongzicili.org	Torrent-Websites
bt.zlofenix.org	Torrent-Trackers
zlotracker.org	Torrent-Websites
zonatorrent.org	Torrent-Websites
zunox.org	Warez
watchseries.ovh	Video
gomoviesfree.page	Video
proxybay.page	Torrent-Websites
vpnfortorrents.page	Torrent-Websites
torrent.parts	Torrent-Websites
piratebay.party	Torrent-Websites
thepiratebay.party	Torrent-Websites
tpb.party	Torrent-Websites
torrent9.ph	Torrent-Websites
123movies.pics	Video
putlocker.pics	Video
playit.pk	Audio
agusiq-torrents.pl	Torrent-Websites
aletorrenty.pl	Torrent-Websites
auratorrent.pl	Torrent-Websites
bluewarez.pl	Warez
caly-film.pl	Video
chomikuj.pl	Video
cinemamovies.pl	Torrent-Websites
darmowe-torrenty.com.pl	Torrent-Websites
darkmachine.pl	Warez
darksiders.pl	Warez
darkw.pl	Warez
darmowe-torenty.pl	Torrent-Websites
devil-torrents.pl	Torrent-Websites
drama-online.pl	Video
dramaqueen.pl	Video
ekino-tv.pl	Video
electro-torrent.pl	Torrent-Websites
elitetorrent.pl	Torrent-Websites
exsite.pl	Warez
exsite24.pl	Warez
exsites.pl	Warez
fileland.pl	Warez
filetracker.pl	Torrent-Websites
hdseans.pl	Video
immortaltorrent.pl	Torrent-Websites
kinol.pl	Video
milliontorrent.pl	Torrent-Trackers, Torrent-Websites
netemx.pl	Torrent-Websites
rstorrent.org.pl	Torrent-Websites
pijafka.pl	Warez
pobieramy24.pl	Warez
prezone.pl	Warez
sdcv.pl	Warez
seehd.pl	Video
shadow-torrents.pl	Torrent-Websites
streettorrent.pl	Torrent-Websites
super-torrent.pl	Torrent-Websites
torrent9.pl	Torrent-Websites
torrentcity.pl	Torrent-Websites
torrentleech.pl	Torrent-Websites
torrentyorg.pl	Torrent-Websites
torrentz.pl	Torrent-Websites
tylkohd.pl	Warez
vizjer.pl	Video
vorek.pl	Warez
yts.pl	Torrent-Websites
putlockers.plus	Video
yts.pm	Torrent-Websites
thepiratebay.press	Torrent-Websites
123movies4u.pro	Video
123moviesfull.pro	Video
123moviesto.pro	Video
123myflixer.pro	Video
animewarrior.pro	Video
atdhe.pro	Video
coolmoviejagg.pro	Torrent-Websites
europixhd.pro	Video
go-torrent.pro	Torrent-Websites
gtorrent.pro	Torrent-Websites
limetor.pro	Torrent-Websites
limetorrents.pro	Torrent-Websites
mrunblock.pro	Proxies
proxybay.pro	Torrent-Websites
seehd.pro	Video
torrent-tracker.pro	Torrent-Websites
torrentdownloads.pro	Torrent-Websites
torrentor.pro	Torrent-Websites
uploadcloud.pro	FileHosting
xmovie8.pro	Video
123movies.promo	Video
fmovies.pub	Video
asnet.pw	Torrent-Websites
tracker.bittor.pw	Torrent-Trackers
tracker2.christianbro.pw	Torrent-Trackers
demonoid.pw	Torrent-Websites
fileupload.pw	FileHosting
glotorrents.pw	Torrent-Websites
discord.heihachi.pw	Torrent-Trackers
myflixer.pw	Video
primewire.pw	Video
proxygalaxy.pw	Torrent-Websites
proxyportal.pw	Proxies
tsundere.pw	Torrent-Trackers
xbit.pw	Torrent-Websites
eztv.d4.re	Torrent-Websites
idope.d4.re	Torrent-Websites
rarbg.d4.re	Torrent-Websites
thepiratebay.d4.re	Torrent-Websites
torlock2.d4.re	Torrent-Websites
torrentdownloads.d4.re	Torrent-Websites
torrentz2.d4.re	Torrent-Websites
yts.d4.re	Torrent-Websites
eztv.re	Torrent-Websites
javtorrent.re	Torrent-Websites
btkitty.red	Torrent-Websites
interviewfor.red	Torrent-Websites
nocensor.rest	Proxies
123movies.review	Video
acg.rip	Torrent-Trackers, Torrent-Websites
blackz.ro	Torrent-Trackers
elitezones.ro	Torrent-Trackers
filelist.ro	Torrent-Websites
metal.iplay.ro	Torrent-Trackers
movi.ucoz.ro	Torrent-Websites
opentracker.i2p.rocks	Torrent-Trackers
piratebayproxy.rocks	Torrent-Websites
rawkbawx.rocks	Torrent-Websites
thepiratebay.rocks	Torrent-Websites
fmovies.rs	Video
kickassanime.rs	Video
123moviess.ru	Video
24warez.ru	Warez
2embed.ru	Video
9anime.ru	Video
retracker.akado-ural.ru	Torrent-Trackers
anime8.ru	Video
animeflv.ru	Video
animeheaven.ru	Video
animet.ru	Torrent-Websites
anisearch.ru	Torrent-Websites
api.bitumconference.ru	Torrent-Trackers
boxset.ru	Audio
cutiegirl.ru	Torrent-Trackers
divineanime.ru	Video
emule-island.ru	Video
engplus.ru	Torrent-Trackers
fast-torrent.ru	Torrent-Websites
ffmovies.ru	Video
flactor.ru	Torrent-Websites
freshremix.ru	Audio, Warez
bt-tracker.gamexp.ru	Torrent-Trackers
gaytorrent.ru	Torrent-Websites
gtorrent.ru	Torrent-Websites
retracker.hotplug.ru	Torrent-Trackers
hurawatch.ru	Video
tracker.ipv6tracker.ru	Torrent-Trackers
kimanime.ru	Video
kissanime.ru	Video, Torrent-Websites
knaben.ru	Torrent-Websites
retracker.krs-ix.ru	Torrent-Trackers
retracker.lanta-net.ru	Torrent-Trackers
layarkaca21.ru	Torrent-Websites
line-net.ru	Torrent-Trackers
maxwarez.ru	Warez
retracker.local.msn-net.ru	Torrent-Trackers
multi-torrent.ru	Torrent-Websites
myflixer.ru	Video
myflixerhd.ru	Video
adminion.n-blade.ru	Torrent-Trackers
retracker.netbynet.ru	Torrent-Trackers
tracker.nextrp.ru	Torrent-Trackers
nowfilms.ru	Torrent-Websites
bt.okmp3.ru	Torrent-Trackers
vps02.net.orel.ru	Torrent-Trackers
tvunderground.org.ru	Torrent-Websites
pctorrent.ru	Torrent-Websites
putlocker9.ru	Video
risbb.ru	Warez
rlsbb.ru	Video
rutracker.ru	Torrent-Websites
ts.saahov.ru	Torrent-Websites
solarmoviez.ru	Torrent-Websites
retracker.spark-rostov.ru	Torrent-Trackers
3rt.tace.ru	Torrent-Trackers
5rt.tace.ru	Torrent-Trackers
rt.tace.ru	Torrent-Trackers
trun.tom.ru	Torrent-Trackers
torrent-epta.ru	Torrent-Websites
torrent-igruha.ru	Torrent-Websites
torrentigruha.ru	Torrent-Websites
torrents.ru	Torrent-Websites
torrents3d.ru	Torrent-Websites
forum.touki.ru	Torrent-Websites
open.touki.ru	Torrent-Trackers
4rvard-warez.ucoz.ru	Warez
edu.uifr.ru	Torrent-Trackers
utorrentfilmi.ru	Torrent-Websites
watchserieshd.ru	Video
z-torrents.ru	Torrent-Websites
5movies.run	Video
123movies.sale	Video
piratebay.sbs	Torrent-Websites
123movies.sc	Video
3movierulz.sc	Video
cricfree.sc	Video
fmovie.sc	Video
fmovies.sc	Video
gomoviefree.sc	Video
putlockerfree.sc	Video
putlockers.sc	Video
123moviess.se	Video
1337x.se	Torrent-Websites
acgnx.se	Torrent-Websites
animebam.se	Video
avxhm.se	Warez
babytorrent.se	Torrent-Websites
thepiratebays.com.se	Torrent-Websites
goflix.se	Video
idope.se	Torrent-Websites
lmshows.se	Video
tracker.opentracker.se	Torrent-Trackers
tracker.pomf.se	Torrent-Trackers
publichd.se	Torrent-Websites
thepiratebay.se	Torrent-Websites
thepiratebayproxylist.se	Torrent-Websites
topnow.se	Video, Torrent-Websites
torrentproject.se	Torrent-Websites
underver.se	Torrent-Websites
x1337x.se	Torrent-Websites
xpau.se	Torrent-Websites
yggtorrent.se	Torrent-Websites
ymovies.se	Video
koli.services	Torrent-Trackers
gogoanime.sh	Video
losmovies.sh	Video
mexa.sh	FileHosting
popcorntime.sh	Torrent-Clients
putlockers.sh	Video
soap2day.sh	Video
torrent9.sh	Torrent-Websites
git.vulnix.sh	Torrent-Trackers
tracker.vulnix.sh	Torrent-Trackers
yesmovies.sh	Video
5mins.shop	Torrent-Websites
putlockers.shop	Video
123freemovies.show	Video
123movie.show	Video
animepace.si	Video
open.demonii.si	Torrent-Trackers
extratorrent.si	Torrent-Websites
kimcartoon.si	Video
nyaa.si	Torrent-Websites
open.stealth.si	Torrent-Trackers
torrentus.si	Torrent-Websites
xmovies8.si	Video
yggtorrent.si	Torrent-Websites
123moviesnew.site	Video
dodi-repacks.site	Torrent-Websites
filmitorrent-org.site	Torrent-Websites
fitgirl-repacks.site	Torrent-Websites
fmoviestv.site	Video
moviego.site	Video
mp3juicemusic.site	Audio
mp3juices.site	Audio
mp3skull.site	Audio
myflixer.site	Video
popcornflix.site	Video
putlocker-new.site	Video
putlocker5movies.site	Video
tpb.skynetcloud.site	Torrent-Websites
tracker.skynetcloud.site	Torrent-Trackers
topeuropix.site	Video
torrent9.site	Torrent-Websites
torrent9.so	Torrent-Websites
thepb.social	Torrent-Websites
couchtuner.space	Video
mrunlock.space	Proxies
zooqle.p4y.space	Torrent-Websites
pirateproxy.space	Torrent-Websites
soundpark.space	Torrent-Websites
unblockproject.space	Proxies
123movies.st	Video
1337x.st	Torrent-Websites
sanet.st	Video
yts.st	Torrent-Websites
0123movie.stream	Video
cricfree.stream	Video
dailyfix.stream	Video
darkanime.stream	Video
football-live.stream	Video
formula1-live.stream	Video
go123.stream	Video
live-nfl.stream	Video
onlineflix.stream	Video
ripple.stream	Video
robinhood.stream	Video
time4tv.stream	Video
ymovies.stream	Video
yoursports.stream	Video
lookmovie.studio	Video
putlocker.style	Video
fasttorrent.su	Torrent-Websites
gnula.su	Video
jkanime.su	Video
retracker.nts.su	Torrent-Trackers
123movies.support	Video
piratebay.surf	Torrent-Websites
tpb.surf	Torrent-Websites
livetv.sx	Video
movie-blog.sx	Torrent-Websites
sumotorrent.sx	Torrent-Websites
fmovies.taxi	Video
123movieshub.tech	Video
mp3juices.tech	Audio
piratebay.tech	Torrent-Websites
proxybay.tech	Torrent-Websites
gonemaweb.ruggieri.tech	Torrent-Websites
torrent.tdjs.tech	Torrent-Trackers
torrentclub.tech	Torrent-Trackers, Torrent-Websites
yesmovies.tech	Video
baypirateproxy.tel	Torrent-Websites
lifeproxy.tel	Torrent-Websites
proxtpbportal.tel	Torrent-Websites
tracker.0x.tf	Torrent-Trackers
eztv.tf	Torrent-Websites
eztv.k8.tf	Torrent-Websites
torrentz2.k8.tf	Torrent-Websites
putlockers.tf	Video
thepiratebay.tips	Torrent-Websites
tracker.coppersurfer.tk	Torrent-Trackers
findmovies.tk	Video
invitemenow.tk	Video
mellimovies2.tk	Video
moviesrus.tk	Torrent-Websites
proxypirate.tk	Torrent-Websites
tpb.sadzawka.tk	Torrent-Websites
yts.tl	Torrent-Websites
torrent.tm	Torrent-Websites
forja.tn	Video
moviz.tn	Video
seriz.tn	Video
123movies.to	Video
1337x.to	Torrent-Websites
1337xto.to	Torrent-Websites
4anime.to	Video, Torrent-Websites
5movies.to	Video, Torrent-Websites
9anime.to	Video, Torrent-Websites
anilinkz.to	Torrent-Websites
board.anime-miako.to	Torrent-Websites
animedao.to	Video
animeultima.to	Video
animixplay.to	Video
azm.to	Video
bflix.to	Video
bs.to	Video
torrent.byte.to	Torrent-Websites
cine.to	Torrent-Websites
cinecalidad.to	Torrent-Websites
d123movies.to	Video
ddl.to	FileHosting
ddl-warez.to	Warez
dropapk.to	FileHosting
dwatchseries.to	Torrent-Websites
ettv.to	Torrent-Websites
ev01.to	Video
ext.to	Torrent-Websites
f2movies.to	Video
fbox.to	Video
tpb.filepit.to	Torrent-Websites
tracker.filepit.to	Torrent-Trackers
film4k.to	Video
flixtor.to	Video
fmovies.to	Video, Torrent-Websites
footballstream.to	Video
fromhot.to	Video
glodls.to	Torrent-Websites
gogomovies.to	Video
goldmovies.to	Video
goojara.to	Video
gounlimited.to	Video
gustatv.to	Video
hdm.to	Video, Torrent-Websites
hif.to	FileHosting
himovies.to	Video
holaanime.to	Video
ibit.to	Torrent-Websites
isohunts.to	Torrent-Websites
iwatchfreestreams.to	Video
katcr.to	Torrent-Websites
kickasstorrents.to	Torrent-Websites
kimcartoon.to	Video, Torrent-Websites
kinox.to	Video
kisstvshow.to	Video
letsupload.to	FileHosting
load.to	FileHosting
mega-stream.to	Video
mlbstreams.to	Video
mobdro.to	Video
movie4k.to	Video
moviegaga.to	Video
movies132.to	Video
movies7.to	Video
moviesjoy.to	Video
moviestars.to	Video
movieworld.to	Torrent-Websites
mp3box.to	Audio
mp3juice.to	Audio
mp3juices.to	Audio
mp3skulls.to	Audio
myflixer.to	Video
myflixertv.to	Video
nbastreams.to	Video
nflstreams.to	Video
nhlstreams.to	Video
nitro.to	Torrent-Websites
nnmclub.to	Torrent-Websites
noxx.to	Video
ogladaj.to	Video
ololo.to	Video
onionplay.to	Video
piratebay-proxy.to	Torrent-Websites
privatehd.to	Torrent-Websites
putlocker1.to	Video
putlocker123.to	Video
putlockertv.to	FileHosting, Video
rainierland.to	Video
rarbg.to	Torrent-Websites
s2dfree.to	Video
sflix.to	Video
skytorrents.to	Torrent-Websites
soap2day.to	Video
solarmovie.to	Video
streamlive.to	Video
supernova.to	Video
swatchseries.to	Video
swefilmer.to	Video
thekickasstorrents.to	Torrent-Websites
thepiratebay2.to	Torrent-Websites
thepiratebay3.to	Torrent-Websites
tinyzonetv.to	Video
torrends.to	Torrent-Websites
torrent9.to	Torrent-Websites
torrentbay.to	Torrent-Websites
torrentcounter.to	Torrent-Websites
torrentgalaxy.to	Torrent-Websites
torrents.to	Torrent-Websites
trailers.to	Video
trec.to	Torrent-Websites
tubidy.to	Audio
turbo.to	FileHosting
ul.to	FileHosting
unblocked.to	Proxies
uploaded.to	FileHosting
ustreamix.to	Video
vumoo.to	Video
coalgirls.wakku.to	Torrent-Websites
wareztown.to	Warez
yesmovies.to	Torrent-Websites
ymovies.to	Video
yts.to	Torrent-Websites
zer0day.to	Torrent-Trackers
mp3juices.today	Audio
myflixer.today	Video
123movies.top	Video
supaflix.1mt.top	Video
supaflix-series.1mt.top	Video
8kun.top	Torrent-Websites
acglover.top	Torrent-Websites
bclearning.top	Torrent-Trackers
boatmy.top	Torrent-Websites
fmovies.top	Video
fux0r.top	Proxies
haikyuu.top	Video
hulkpop.top	Audio
idope.top	Torrent-Websites
mirrorbay.top	Torrent-Websites
motv.top	Video
piratebayproxy.top	Torrent-Websites
piratebays.top	Torrent-Websites
thepiratebay0.top	Torrent-Websites
thepiratebay1.top	Torrent-Websites
unblockit.top	Torrent-Websites
veranime.top	Video
tr2.ysagin.top	Torrent-Trackers
ytmp3.top	Audio
h4.trakx.nibba.trade	Torrent-Trackers
bolly4u.tube	Video
reboot.tube	Video
123moviesgo.tv	Video
123moviesx.tv	Video
720pstream.tv	Video
stream.allsprk.tv	Video
animebytes.tv	Torrent-Websites
animefever.tv	Video
animefreak.tv	Video
animeid.tv	Video
animekisa.tv	Video
animerush.tv	Video
animeshow.tv	Video
animetake.tv	Video
animevibe.tv	Video
attacker.tv	Video
b98.tv	Video
baibako.tv	Torrent-Trackers
buffstreams.tv	Video
cartooncrazy.tv	Video
adm.category5.tv	Torrent-Trackers
cinemitas.tv	Video
cliver.tv	Video
cloudvideo.tv	Video
cmovies.tv	Video
dize.tv	Video
duboku.tv	Video
efilmy.tv	Video
einthusan.tv	Torrent-Websites
ettv.tv	Torrent-Websites
filewarez.tv	Torrent-Websites, Warez
filmxy.tv	Video
firstsrowsports.tv	Video
govod.tv	Video
hejo.tv	Video
internetowa.tv	Video
isohunt.tv	Torrent-Websites
k-streaming.tv	Video
liveonscore.tv	Video
lostfilm.tv	Torrent-Websites
m4ufree.tv	Torrent-Websites
m4uhd.tv	Video
mediaclub.tv	Torrent-Trackers, Torrent-Websites
miomio.tv	Torrent-Websites
moonline.tv	Video
moviekids.tv	Video
mp3juice.tv	Audio
netanime.tv	Video
netu.tv	Video
nites.tv	Video
nodata.tv	Audio
nwanime.tv	Video
optimovision.tv	Video
pantsubase.tv	Video
retrovision.tv	Video
sockshares.tv	Video
strumyk.tv	Video
thepiratefilmestorrent.tv	Torrent-Websites
thewatchcartoononline.tv	Video
tinyzone.tv	Video
topcartoons.tv	Video
torrentdosfilmes.tv	Torrent-Websites
torrentkitty.tv	Torrent-Websites
torrentmegafilmes.tv	Torrent-Websites
torrentsfilmeshd.tv	Torrent-Websites
ustv247.tv	Video
ustvgo.tv	Video
uwatchfree.tv	Torrent-Websites
verpelisonline.tv	Video
vodlocker.tv	Torrent-Websites
watchgameofthrones.tv	Video
watchserieshd.tv	Video
watchsomuch.tv	Video
wco.tv	Video
ymovies.tv	Torrent-Websites
ytanime.tv	Video
zonatorrent.tv	Torrent-Websites
1337x.tw	Torrent-Websites
mayi.tw	Torrent-Websites
unblocked.tw	Proxies
skvtorrent.at.ua	Torrent-Websites
tracker.ex.ua	Torrent-Trackers
sport-video.org.ua	Torrent-Websites
nagios.tks.sumy.ua	Torrent-Trackers
ultra.zt.ua	Torrent-Trackers
movieheaven.co.uk	Video
piratebae.co.uk	Torrent-Websites
piratebaysmirror.co.uk	Torrent-Websites
piratebayukproxy.co.uk	Torrent-Websites
proxylove.co.uk	Torrent-Websites
thepb.co.uk	Torrent-Websites
chanchan.uchuu.co.uk	Torrent-Trackers
tracker.nyaa.uk	Torrent-Trackers
1337x.org.uk	Torrent-Websites
pleasuredome.org.uk	Torrent-Websites
tracker.swateam.org.uk	Torrent-Trackers
pirateproxylove.uk	Torrent-Websites
thepb.uk	Torrent-Websites
unblockpirate.uk	Torrent-Websites
123movie.uno	Video
cuevana.uno	Video
dutafilm.uno	Video
gomovies.uno	Video
seehd.uno	Video
torrent9.uno	Torrent-Websites
torrentkitty.uno	Torrent-Websites
animeland.us	Video
arconaitv.us	Video
cmovies.us	Video
eprojectfreetv.us	Video
iptvlinksm3u.us	Video
keysmovie.us	Video
leflix.us	Video
losmovies.us	Video
zephir.monocul.us	Torrent-Trackers
putlockers9.us	Video
putlockershd.us	Video
sexy-pics.us	Torrent-Websites
soul-anime.us	Video
vidcloud.us	Video
gogoanime.vc	Video
myflixer.vc	Video
primewire.vc	Video
putlocker.vc	Video
yts.vc	Torrent-Websites
pirateproxy.vet	Torrent-Websites
torrent.vet	Torrent-Websites
cuevana3.video	Video
jkanime.video	Video
putlocker123.video	Video
thepiratebay.vin	Torrent-Websites
babytorrent.vip	Torrent-Websites
cmovies.vip	Video
dubbedanime.vip	Video
duboku.vip	Video
fmovieshd.vip	Video
nyafilmer.vip	Video
putlocker.vip	Video
saiko.vip	Video
thepiratebay.vip	Torrent-Websites
uniquestream.vip	Video
yifytorrent.vip	Torrent-Websites
fshare.vn	FileHosting
best-movies.watch	Torrent-Websites
bflix.watch	Video
go123movies.watch	Video
vmovee.watch	Video
123movies.website	Video, Torrent-Websites
movies123.website	Video
eztv.wf	Torrent-Websites
nyaa.tracker.wf	Torrent-Trackers
sukebei.tracker.wf	Torrent-Trackers
putlockers.wiki	Video
thepiratebay.wiki	Torrent-Websites
ddgroupclub.win	Torrent-Websites
piratebays.win	Torrent-Websites
softpilot.win	Torrent-Websites
ssrmovies.win	Video
tpbay.win	Torrent-Websites
unblocked.win	Proxies
unblocker.win	Proxies
123movies.wine	Video
123movies.work	Video
cinevood.work	Video
fmovies.world	Video
hdf.world	Torrent-Websites
pirateproxy.world	Torrent-Websites
0123movie.ws	Video
best-moviez.ws	Video
bt-club.ws	Torrent-Trackers
extremlymtorrents.ws	Torrent-Websites
ffmovies.ws	Video
fost.ws	Torrent-Websites
tracker.gigatorrents.ws	Torrent-Trackers
kiss-anime.ws	Video
limetorrent.ws	Torrent-Websites
mkvcage.ws	Torrent-Websites
w13.monkrus.ws	Torrent-Websites
w14.monkrus.ws	Torrent-Websites
moonline.ws	Video
mp3-juices.ws	Audio
myflixer.ws	Video
neverland.ws	Warez
torrent.nwps.ws	Torrent-Trackers
ololo.ws	Video
openloadmovie.ws	Torrent-Websites
serials.ws	Warez
stream2watch.ws	Video
streamm4u.ws	Video
tamilrockers.ws	Video, Torrent-Websites
voirfilms.ws	Video
x1337x.ws	Torrent-Websites
yts.ws	Torrent-Websites
1337x.wtf	Torrent-Websites
fmovies.wtf	Video
mypiratebay.wtf	Torrent-Websites
pb.wtf	Torrent-Websites
piratebays.wtf	Torrent-Websites
solarmovies.wtf	Video
tpb.wtf	Torrent-Websites
u.wwwww.wtf	Torrent-Trackers
w.wwwww.wtf	Torrent-Trackers
123movieonline.xyz	Video
1337xto.xyz	Torrent-Websites
23movies.xyz	Video
247movies.xyz	Video
bt.3kb.xyz	Torrent-Trackers
6stream.xyz	Video
allmoviefree.xyz	Video
animeglare.xyz	Video
animeout.xyz	Torrent-Websites
tracker.anonwebz.xyz	Torrent-Trackers
asger.xyz	Torrent-Trackers
azmovies.xyz	Torrent-Websites
beyondhd.xyz	Torrent-Websites
blutopia.xyz	Torrent-Websites
btorrent.xyz	Torrent-Clients, Torrent-Websites
cestrm.xyz	Video
cruzing.xyz	Torrent-Websites
emetsbank.xyz	Audio
exsite24.xyz	Warez
filmstorrent.xyz	Torrent-Websites
fsapi.xyz	Video
full-tv.xyz	Video
fullmoviz.xyz	Video
fux0r.xyz	Proxies
gdrivedl.xyz	Video
gmovies.xyz	Video
gostream-hd.xyz	Video
hd4.xyz	Torrent-Websites
tracker.iamhansen.xyz	Torrent-Trackers
idope.xyz	Torrent-Websites
ind-unblock.xyz	Proxies
joytorrent.xyz	Torrent-Websites
knaben.xyz	Torrent-Websites
ligaxxi.xyz	Video
limetorrents.xyz	Torrent-Websites
nbastreams.xyz	Video
opentracker.xyz	Torrent-Trackers
p4pirate.xyz	Video
piraat.xyz	Torrent-Websites
piratebay1.xyz	Torrent-Websites
piratenow.xyz	Torrent-Websites
piratetoday.xyz	Torrent-Websites
piratez.xyz	Torrent-Websites
pobieramy24.xyz	Warez
proxybay.xyz	Torrent-Websites
publictracker.xyz	Torrent-Trackers
putlockerfull.xyz	Video
katcr.t0r.xyz	Torrent-Websites
teatv.xyz	Video
timetowatch.xyz	Video
torrentz2fr.xyz	Torrent-Websites
torrentz2k.xyz	Torrent-Websites
uk-unblock.xyz	Proxies
tracker.uw0.xyz	Torrent-Trackers
omg.wtftrackr.xyz	Torrent-Trackers
wwmovies.xyz	Video
xoomtv.xyz	Video
ytshindi.xyz	Torrent-Websites
ytstvmovies.xyz	Torrent-Websites
tracker.zerobytes.xyz	Torrent-Trackers
forever-tracker.zooki.xyz	Torrent-Trackers
free-tracker.zooki.xyz	Torrent-Trackers
public-tracker.zooki.xyz	Torrent-Trackers
tracker-v6.zooki.xyz	Torrent-Trackers
123movies.yt	Video
eztv.yt	Torrent-Websites
yts.yt	Torrent-Websites
9anime.zone	Video
bypassed.zone	Proxies
limetorrents.zone	Torrent-Websites
thepiratebay.zone	Torrent-Websites
yesmovies.zone	Video
yts.zone	Video
### BLACKLIST ASN ###
### BLACKLIST IPv4 ###
### BLACKLIST IPv6 ###
### BLACKLIST EOF ###
